Member State;Gross contributions;Credit from staff;Net contributions;Year;Month;Day;Period;iso3c
Afghanistan;215923;19549;196374;2020;1;1;01/01/2020;AFG
Albania;246769;22342;224427;2020;1;1;01/01/2020;ALB
Algeria;4256760;385397;3871363;2020;1;1;01/01/2020;DZA
Andorra;154230;13964;140266;2020;1;1;01/01/2020;AND
Angola;308461;27927;280534;2020;1;1;01/01/2020;AGO
Antigua and Barbuda;61692;5585;56107;2020;1;1;01/01/2020;ATG
Argentina;28224166;2555348;25668818;2020;1;1;01/01/2020;ARG
Armenia;215923;19549;196374;2020;1;1;01/01/2020;ARM
Australia;68169844;6171933;61997911;2020;1;1;01/01/2020;AUS
Austria;20882798;1890678;18992120;2020;1;1;01/01/2020;AUT
Azerbaijan;1511458;136844;1374614;2020;1;1;01/01/2020;AZE
Bahamas;555230;50269;504961;2020;1;1;01/01/2020;BHS
Bahrain;1542304;139636;1402668;2020;1;1;01/01/2020;BHR
Bangladesh;308461;27927;280534;2020;1;1;01/01/2020;BGD
Barbados;215923;19549;196374;2020;1;1;01/01/2020;BRB
Belarus;1511458;136844;1374614;2020;1;1;01/01/2020;BLR
Belgium;25324634;2292831;23031803;2020;1;1;01/01/2020;BEL
Belize;30846;2793;28053;2020;1;1;01/01/2020;BLZ
Benin;92538;8378;84160;2020;1;1;01/01/2020;BEN
Bhutan;30846;2793;28053;2020;1;1;01/01/2020;BTN
Bolivia;493537;44684;448853;2020;1;1;01/01/2020;BOL
Bosnia and Herzegovina;370153;33513;336640;2020;1;1;01/01/2020;BIH
Botswana;431845;39098;392747;2020;1;1;01/01/2020;BWA
Brazil;90934253;8232968;82701285;2020;1;1;01/01/2020;BRA
Brunei Darussalam;771152;69818;701334;2020;1;1;01/01/2020;BRN
Bulgaria;1418920;128466;1290454;2020;1;1;01/01/2020;BGR
Burkina Faso;92538;8378;84160;2020;1;1;01/01/2020;BFA
Burundi;30846;2793;28053;2020;1;1;01/01/2020;BDI
Cape Verde;30846;2793;28053;2020;1;1;01/01/2020;CPV
Cambodia;185076;16756;168320;2020;1;1;01/01/2020;KHM
Cameroon;400999;36305;364694;2020;1;1;01/01/2020;CMR
Canada;84333191;7635324;76697867;2020;1;1;01/01/2020;CAN
Central African Republic;30846;2793;28053;2020;1;1;01/01/2020;CAF
Chad;123384;11171;112213;2020;1;1;01/01/2020;TCD
Chile;12554356;1136641;11417715;2020;1;1;01/01/2020;CHL
China;370307226;33526724;336780502;2020;1;1;01/01/2020;CHN
Colombia;8883672;804306;8079366;2020;1;1;01/01/2020;COL
Comoros;30846;2793;28053;2020;1;1;01/01/2020;COM
Congo;185076;16756;168320;2020;1;1;01/01/2020;COG
Costa Rica;1912457;173149;1739308;2020;1;1;01/01/2020;CRI
Côte d’Ivoire;400999;36305;364694;2020;1;1;01/01/2020;CIV
Croatia;2375148;215040;2160108;2020;1;1;01/01/2020;HRV
Cuba;2467687;223418;2244269;2020;1;1;01/01/2020;CUB
Cyprus;1110459;100538;1009921;2020;1;1;01/01/2020;CYP
Czech Republic;9593132;868539;8724593;2020;1;1;01/01/2020;CZE
Democratic People’s Republic of Korea;185076;16756;168320;2020;1;1;01/01/2020;PRK
Democratic Republic of the Congo;308461;27927;280534;2020;1;1;01/01/2020;ZAR
Denmark;17088730;1547172;15541558;2020;1;1;01/01/2020;DNK
Djibouti;30846;2793;28053;2020;1;1;01/01/2020;DJI
Dominica;30846;2793;28053;2020;1;1;01/01/2020;DMA
Dominican Republic;1634842;148015;1486827;2020;1;1;01/01/2020;DOM
Ecuador;2467687;223418;2244269;2020;1;1;01/01/2020;ECU
Egypt;5737372;519448;5217924;2020;1;1;01/01/2020;EGY
El Salvador;370153;33513;336640;2020;1;1;01/01/2020;SLV
Equatorial Guinea;493537;44684;448853;2020;1;1;01/01/2020;GNQ
Eritrea;30846;2793;28053;2020;1;1;01/01/2020;ERI
Estonia;1202997;108916;1094081;2020;1;1;01/01/2020;EST
Eswatini;61692;5585;56107;2020;1;1;01/01/2020;SWZ
Ethiopia;308461;27927;280534;2020;1;1;01/01/2020;ETH
Fiji;92538;8378;84160;2020;1;1;01/01/2020;FJI
Finland;12986201;1175739;11810462;2020;1;1;01/01/2020;FIN
France;136555610;12363416;124192194;2020;1;1;01/01/2020;FRA
Gabon;462691;41891;420800;2020;1;1;01/01/2020;GAB
Gambia;30846;2793;28053;2020;1;1;01/01/2020;GMB
Georgia;246769;22342;224427;2020;1;1;01/01/2020;GEO
Germany;187852646;17007726;170844920;2020;1;1;01/01/2020;DEU
Ghana;462691;41891;420800;2020;1;1;01/01/2020;GHA
Greece;11289666;1022139;10267527;2020;1;1;01/01/2020;GRC
Grenada;30846;2793;28053;2020;1;1;01/01/2020;GRD
Guatemala;1110459;100538;1009921;2020;1;1;01/01/2020;GTM
Guinea;92538;8378;84160;2020;1;1;01/01/2020;GIN
Guinea-Bissau;30846;2793;28053;2020;1;1;01/01/2020;GNB
Guyana;61692;5585;56107;2020;1;1;01/01/2020;GUY
Haiti;92538;8378;84160;2020;1;1;01/01/2020;HTI
Honduras;277615;25135;252480;2020;1;1;01/01/2020;HND
Hungary;6354293;575302;5778991;2020;1;1;01/01/2020;HUN
Iceland;863690;78196;785494;2020;1;1;01/01/2020;ISL
India;25725633;2329137;23396496;2020;1;1;01/01/2020;IND
Iran (Islamic Republic of);12276741;1111507;11165234;2020;1;1;01/01/2020;IRN
Iraq;3979145;360262;3618883;2020;1;1;01/01/2020;IRQ
Ireland;11443897;1036103;10407794;2020;1;1;01/01/2020;IRL
Israel;15114581;1368438;13746143;2020;1;1;01/01/2020;ISR
Italy;102007997;9235558;92772439;2020;1;1;01/01/2020;ITA
Jamaica;246769;22342;224427;2020;1;1;01/01/2020;JAM
Japan;264165855;23916940;240248915;2020;1;1;01/01/2020;JPN
Jordan;647768;58647;589121;2020;1;1;01/01/2020;JOR
Kazakhstan;5490603;497106;4993497;2020;1;1;01/01/2020;KAZ
Kenya;740306;67026;673280;2020;1;1;01/01/2020;KEN
Kiribati;30846;2793;28053;2020;1;1;01/01/2020;KIR
Kuwait;7773213;703768;7069445;2020;1;1;01/01/2020;KWT
Kyrgyzstan;61692;5585;56107;2020;1;1;01/01/2020;KGZ
Lao People’s Democratic Republic;154230;13964;140266;2020;1;1;01/01/2020;LAO
Latvia;1449766;131258;1318508;2020;1;1;01/01/2020;LVA
Lebanon;1449766;131258;1318508;2020;1;1;01/01/2020;LBN
Lesotho;30846;2793;28053;2020;1;1;01/01/2020;LSO
Liberia;30846;2793;28053;2020;1;1;01/01/2020;LBR
Libya;925383;83782;841601;2020;1;1;01/01/2020;LBY
Liechtenstein;277615;25135;252480;2020;1;1;01/01/2020;LIE
Lithuania;2190072;198284;1991788;2020;1;1;01/01/2020;LTU
Luxembourg;2066688;187113;1879575;2020;1;1;01/01/2020;LUX
Madagascar;123384;11171;112213;2020;1;1;01/01/2020;MDG
Malawi;61692;5585;56107;2020;1;1;01/01/2020;MWI
Malaysia;10518514;952321;9566193;2020;1;1;01/01/2020;MYS
Maldives;123384;11171;112213;2020;1;1;01/01/2020;MDV
Mali;123384;11171;112213;2020;1;1;01/01/2020;MLI
Malta;524383;47476;476907;2020;1;1;01/01/2020;MLT
Marshall Islands;30846;2793;28053;2020;1;1;01/01/2020;MHL
Mauritania;61692;5585;56107;2020;1;1;01/01/2020;MRT
Mauritius;339307;30720;308587;2020;1;1;01/01/2020;MUS
Mexico;39853139;3608207;36244932;2020;1;1;01/01/2020;MEX
Micronesia (Federated States of);30846;2793;28053;2020;1;1;01/01/2020;FSM
Monaco;339307;30720;308587;2020;1;1;01/01/2020;MCO
Mongolia;154230;13964;140266;2020;1;1;01/01/2020;MNG
Montenegro;123384;11171;112213;2020;1;1;01/01/2020;MNE
Morocco;1696535;153600;1542935;2020;1;1;01/01/2020;MAR
Mozambique;123384;11171;112213;2020;1;1;01/01/2020;MOZ
Myanmar;308461;27927;280534;2020;1;1;01/01/2020;MMR
Namibia;277615;25135;252480;2020;1;1;01/01/2020;NAM
Nauru;30846;2793;28053;2020;1;1;01/01/2020;NRU
Nepal;215923;19549;196374;2020;1;1;01/01/2020;NPL
Netherlands;41827289;3786942;38040347;2020;1;1;01/01/2020;NLD
New Zealand;8976210;812684;8163526;2020;1;1;01/01/2020;NZL
Nicaragua;154230;13964;140266;2020;1;1;01/01/2020;NIC
Niger;61692;5585;56107;2020;1;1;01/01/2020;NER
Nigeria;7711521;698183;7013338;2020;1;1;01/01/2020;NGA
North Macedonia;215923;19549;196374;2020;1;1;01/01/2020;MKD
Norway;23257947;2105718;21152229;2020;1;1;01/01/2020;NOR
Oman;3547300;321164;3226136;2020;1;1;01/01/2020;OMN
Pakistan;3547300;321164;3226136;2020;1;1;01/01/2020;PAK
Palau;30846;2793;28053;2020;1;1;01/01/2020;PLW
Panama;1388074;125673;1262401;2020;1;1;01/01/2020;PAN
Papua New Guinea;308461;27927;280534;2020;1;1;01/01/2020;PNG
Paraguay;493537;44684;448853;2020;1;1;01/01/2020;PRY
Peru;4688605;424495;4264110;2020;1;1;01/01/2020;PER
Philippines;6323447;572510;5750937;2020;1;1;01/01/2020;PHL
Poland;24738559;2239769;22498790;2020;1;1;01/01/2020;POL
Portugal;10796129;977456;9818673;2020;1;1;01/01/2020;PRT
Qatar;8698595;787550;7911045;2020;1;1;01/01/2020;QAT
Republic of Korea;69928070;6331119;63596951;2020;1;1;01/01/2020;KOR
Moldova;92538;8378;84160;2020;1;1;01/01/2020;MDA
Romania;6107525;552961;5554564;2020;1;1;01/01/2020;ROM
Russian Federation;74184830;6716516;67468314;2020;1;1;01/01/2020;RUS
Rwanda;92538;8378;84160;2020;1;1;01/01/2020;RWA
Saint Kitts and Nevis;30846;2793;28053;2020;1;1;01/01/2020;KN1
Saint Lucia;30846;2793;28053;2020;1;1;01/01/2020;LCA
Saint Vincent and the Grenadines;30846;2793;28053;2020;1;1;01/01/2020;VCT
Samoa;30846;2793;28053;2020;1;1;01/01/2020;WSM
San Marino;61692;5585;56107;2020;1;1;01/01/2020;SMR
Sao Tome and Principe;30846;2793;28053;2020;1;1;01/01/2020;STP
Saudi Arabia;36151609;3273080;32878529;2020;1;1;01/01/2020;SAU
Senegal;215923;19549;196374;2020;1;1;01/01/2020;SEN
Serbia;863690;78196;785494;2020;1;1;01/01/2020;SER
Seychelles;61692;5585;56107;2020;1;1;01/01/2020;SYC
Sierra Leone;30846;2793;28053;2020;1;1;01/01/2020;SLE
Singapore;14960350;1354474;13605876;2020;1;1;01/01/2020;SGP
Slovakia;4719451;427288;4292163;2020;1;1;01/01/2020;SVK
Slovenia;2344302;212247;2132055;2020;1;1;01/01/2020;SVN
Solomon Islands;30846;2793;28053;2020;1;1;01/01/2020;SLB
Somalia;30846;2793;28053;2020;1;1;01/01/2020;SOM
South Africa;8390135;759623;7630512;2020;1;1;01/01/2020;ZAF
South Sudan;185076;16756;168320;2020;1;1;01/01/2020;SSD
Spain;66195694;5993199;60202495;2020;1;1;01/01/2020;ESP
Sri Lanka;1357228;122880;1234348;2020;1;1;01/01/2020;LKA
Sudan;308461;27927;280534;2020;1;1;01/01/2020;SDN
Suriname;154230;13964;140266;2020;1;1;01/01/2020;SUR
Sweden;27946551;2530213;25416338;2020;1;1;01/01/2020;SWE
Switzerland;35503842;3214432;32289410;2020;1;1;01/01/2020;CHE
Syrian Arab Republic;339307;30720;308587;2020;1;1;01/01/2020;SYR
Tajikistan;123384;11171;112213;2020;1;1;01/01/2020;TJK
Thailand;9469748;857368;8612380;2020;1;1;01/01/2020;THA
Timor-Leste;61692;5585;56107;2020;1;1;01/01/2020;TMP
Togo;61692;5585;56107;2020;1;1;01/01/2020;TGO
Tonga;30846;2793;28053;2020;1;1;01/01/2020;TON
Trinidad and Tobago;1233843;111709;1122134;2020;1;1;01/01/2020;TTO
Tunisia;771152;69818;701334;2020;1;1;01/01/2020;TUN
Turkey;42289980;3828833;38461147;2020;1;1;01/01/2020;TUR
Turkmenistan;1017921;92160;925761;2020;1;1;01/01/2020;TKM
Tuvalu;30846;2793;28053;2020;1;1;01/01/2020;TUV
Uganda;246769;22342;224427;2020;1;1;01/01/2020;UGA
Ukraine;1758227;159186;1599041;2020;1;1;01/01/2020;UKR
United Arab Emirates;19001187;1720322;17280865;2020;1;1;01/01/2020;ARE
United Kingdom of Great Britain and  Northern Ireland;140874061;12754398;128119663;2020;1;1;01/01/2020;GBR
United Republic of Tanzania;308461;27927;280534;2020;1;1;01/01/2020;TZA
United States of America;678613826;–a;678613826;2020;1;1;01/01/2020;USA
Uruguay;2683609;242968;2440641;2020;1;1;01/01/2020;URY
Uzbekistan;987075;89367;897708;2020;1;1;01/01/2020;UZB
Vanuatu;30846;2793;28053;2020;1;1;01/01/2020;VUT
Venezuela;22455948;2033107;20422841;2020;1;1;01/01/2020;VEN
Viet Nam;2375148;215040;2160108;2020;1;1;01/01/2020;VNM
Yemen;308461;27927;280534;2020;1;1;01/01/2020;YEM
Zambia;277615;25135;252480;2020;1;1;01/01/2020;ZMB
Zimbabwe;154230;13964;140266;2020;1;1;01/01/2020;ZWE
Indonesia;16749423;1516452;15232971;2020;1;1;01/01/2020;IDN
Afghanistan;214520;19344;195176;2019;1;1;01/01/2019;AFG
Albania;245166;22108;223058;2019;1;1;01/01/2019;ALB
Algeria;4229115;381363;3847752;2019;1;1;01/01/2019;DZA
Andorra;153229;13817;139412;2019;1;1;01/01/2019;AND
Angola;306458;27635;278823;2019;1;1;01/01/2019;AGO
Antigua and Barbuda;61292;5527;55765;2019;1;1;01/01/2019;ATG
Argentina;28040869;2528598;25512271;2019;1;1;01/01/2019;ARG
Armenia;214520;19344;195176;2019;1;1;01/01/2019;ARM
Australia;67727127;6107323;61619804;2019;1;1;01/01/2019;AUS
Austria;20747179;1870886;18876293;2019;1;1;01/01/2019;AUT
Azerbaijan;1501642;135412;1366230;2019;1;1;01/01/2019;AZE
Bahamas;551624;49743;501881;2019;1;1;01/01/2019;BHS
Bahrain;1532288;138175;1394113;2019;1;1;01/01/2019;BHR
Bangladesh;306458;27635;278823;2019;1;1;01/01/2019;BGD
Barbados;214520;19344;195176;2019;1;1;01/01/2019;BRB
Belarus;1501642;135412;1366230;2019;1;1;01/01/2019;BLR
Belgium;25160168;2268829;22891339;2019;1;1;01/01/2019;BEL
Belize;30646;2763;27883;2019;1;1;01/01/2019;BLZ
Benin;91937;8290;83647;2019;1;1;01/01/2019;BEN
Bhutan;30646;2763;27883;2019;1;1;01/01/2019;BTN
Bolivia;490332;44216;446116;2019;1;1;01/01/2019;BOL
Bosnia and Herzegovina;367749;33162;334587;2019;1;1;01/01/2019;BIH
Botswana;429040;38689;390351;2019;1;1;01/01/2019;BWA
Brazil;90343697;8146782;82196915;2019;1;1;01/01/2019;BRA
Brunei Darussalam;766144;69087;697057;2019;1;1;01/01/2019;BRN
Bulgaria;1409705;127121;1282584;2019;1;1;01/01/2019;BGR
Burkina Faso;91937;8290;83647;2019;1;1;01/01/2019;BFA
Burundi;30646;2763;27883;2019;1;1;01/01/2019;BDI
Cape Verde;30646;2763;27883;2019;1;1;01/01/2019;CPV
Cambodia;183875;16581;167294;2019;1;1;01/01/2019;KHM
Cameroon;398395;35925;362470;2019;1;1;01/01/2019;CMR
Canada;83785505;7555394;76230111;2019;1;1;01/01/2019;CAN
Central African Republic;30646;2763;27883;2019;1;1;01/01/2019;CAF
Chad;122583;11054;111529;2019;1;1;01/01/2019;TCD
Chile;12472824;1124743;11348081;2019;1;1;01/01/2019;CHL
China;367902337;33175752;334726585;2019;1;1;01/01/2019;CHN
Colombia;8825978;795887;8030091;2019;1;1;01/01/2019;COL
Comoros;30646;2763;27883;2019;1;1;01/01/2019;COM
Congo;183875;16581;167294;2019;1;1;01/01/2019;COG
Costa Rica;1900037;171337;1728700;2019;1;1;01/01/2019;CRI
Côte d’Ivoire;398395;35925;362470;2019;1;1;01/01/2019;CIV
Croatia;2359723;212789;2146934;2019;1;1;01/01/2019;HRV
Cuba;2451661;221080;2230581;2019;1;1;01/01/2019;CUB
Cyprus;1103247;99486;1003761;2019;1;1;01/01/2019;CYP
Czech Republic;9530831;859447;8671384;2019;1;1;01/01/2019;CZE
Democratic People’s Republic of Korea;183875;16581;167294;2019;1;1;01/01/2019;PRK
Democratic Republic of the Congo;306458;27635;278823;2019;1;1;01/01/2019;ZAR
Denmark;16977750;1530976;15446774;2019;1;1;01/01/2019;DNK
Djibouti;30646;2763;27883;2019;1;1;01/01/2019;DJI
Dominica;30646;2763;27883;2019;1;1;01/01/2019;DMA
Dominican Republic;1624225;146466;1477759;2019;1;1;01/01/2019;DOM
Ecuador;2451661;221080;2230581;2019;1;1;01/01/2019;ECU
Egypt;5700111;514010;5186101;2019;1;1;01/01/2019;EGY
El Salvador;367749;33162;334587;2019;1;1;01/01/2019;SLV
Equatorial Guinea;490332;44216;446116;2019;1;1;01/01/2019;GNQ
Eritrea;30646;2763;27883;2019;1;1;01/01/2019;ERI
Estonia;1195184;107777;1087407;2019;1;1;01/01/2019;EST
Eswatini;61292;5527;55765;2019;1;1;01/01/2019;SWZ
Ethiopia;306458;27635;278823;2019;1;1;01/01/2019;ETH
Fiji;91937;8290;83647;2019;1;1;01/01/2019;FJI
Finland;12901864;1163432;11738432;2019;1;1;01/01/2019;FIN
France;135668775;12233990;123434785;2019;1;1;01/01/2019;FRA
Gabon;459686;41452;418234;2019;1;1;01/01/2019;GAB
Gambia;30646;2763;27883;2019;1;1;01/01/2019;GMB
Georgia;245166;22108;223058;2019;1;1;01/01/2019;GEO
Germany;186632672;16829682;169802990;2019;1;1;01/01/2019;DEU
Ghana;459686;41452;418234;2019;1;1;01/01/2019;GHA
Greece;11216348;1011439;10204909;2019;1;1;01/01/2019;GRC
Grenada;30646;2763;27883;2019;1;1;01/01/2019;GRD
Guatemala;1103247;99486;1003761;2019;1;1;01/01/2019;GTM
Guinea;91937;8290;83647;2019;1;1;01/01/2019;GIN
Guinea-Bissau;30646;2763;27883;2019;1;1;01/01/2019;GNB
Guyana;61292;5527;55765;2019;1;1;01/01/2019;GUY
Haiti;91937;8290;83647;2019;1;1;01/01/2019;HTI
Honduras;275812;24871;250941;2019;1;1;01/01/2019;HND
Hungary;6313026;569280;5743746;2019;1;1;01/01/2019;HUN
Iceland;858081;77378;780703;2019;1;1;01/01/2019;ISL
India;25558563;2304755;23253808;2019;1;1;01/01/2019;IND
Iran (Islamic Republic of);12197012;1099871;11097141;2019;1;1;01/01/2019;IRN
Iraq;3953303;356491;3596812;2019;1;1;01/01/2019;IRQ
Ireland;11369576;1025257;10344319;2019;1;1;01/01/2019;IRL
Israel;15016422;1354113;13662309;2019;1;1;01/01/2019;ISR
Italy;101345525;9138877;92206648;2019;1;1;01/01/2019;ITA
Jamaica;245166;22108;223058;2019;1;1;01/01/2019;JAM
Japan;262450280;23666567;238783713;2019;1;1;01/01/2019;JPN
Jordan;643561;58034;585527;2019;1;1;01/01/2019;JOR
Kazakhstan;5454945;491902;4963043;2019;1;1;01/01/2019;KAZ
Kenya;735498;66324;669174;2019;1;1;01/01/2019;KEN
Kiribati;30646;2763;27883;2019;1;1;01/01/2019;KIR
Kuwait;7722731;696401;7026330;2019;1;1;01/01/2019;KWT
Kyrgyzstan;61292;5527;55765;2019;1;1;01/01/2019;KGZ
Lao People’s Democratic Republic;153229;13817;139412;2019;1;1;01/01/2019;LAO
Latvia;1440351;129885;1310466;2019;1;1;01/01/2019;LVA
Lebanon;1440351;129885;1310466;2019;1;1;01/01/2019;LBN
Lesotho;30646;2763;27883;2019;1;1;01/01/2019;LSO
Liberia;30646;2763;27883;2019;1;1;01/01/2019;LBR
Libya;919373;82905;836468;2019;1;1;01/01/2019;LBY
Liechtenstein;275812;24871;250941;2019;1;1;01/01/2019;LIE
Lithuania;2175849;196208;1979641;2019;1;1;01/01/2019;LTU
Luxembourg;2053266;185154;1868112;2019;1;1;01/01/2019;LUX
Madagascar;122583;11054;111529;2019;1;1;01/01/2019;MDG
Malawi;61292;5527;55765;2019;1;1;01/01/2019;MWI
Malaysia;10450204;942352;9507852;2019;1;1;01/01/2019;MYS
Maldives;122583;11054;111529;2019;1;1;01/01/2019;MDV
Mali;122583;11054;111529;2019;1;1;01/01/2019;MLI
Malta;520978;46980;473998;2019;1;1;01/01/2019;MLT
Marshall Islands;30646;2763;27883;2019;1;1;01/01/2019;MHL
Mauritania;61292;5527;55765;2019;1;1;01/01/2019;MRT
Mauritius;337103;30398;306705;2019;1;1;01/01/2019;MUS
Mexico;39594320;3570435;36023885;2019;1;1;01/01/2019;MEX
Micronesia (Federated States of);30646;2763;27883;2019;1;1;01/01/2019;FSM
Monaco;337103;30398;306705;2019;1;1;01/01/2019;MCO
Mongolia;153229;13817;139412;2019;1;1;01/01/2019;MNG
Montenegro;122583;11054;111529;2019;1;1;01/01/2019;MNE
Morocco;1685517;151993;1533524;2019;1;1;01/01/2019;MAR
Mozambique;122583;11054;111529;2019;1;1;01/01/2019;MOZ
Myanmar;306458;27635;278823;2019;1;1;01/01/2019;MMR
Namibia;275812;24871;250941;2019;1;1;01/01/2019;NAM
Nauru;30646;2763;27883;2019;1;1;01/01/2019;NRU
Nepal;214520;19344;195176;2019;1;1;01/01/2019;NPL
Netherlands;41555649;3747299;37808350;2019;1;1;01/01/2019;NLD
New Zealand;8917916;804177;8113739;2019;1;1;01/01/2019;NZL
Nicaragua;153229;13817;139412;2019;1;1;01/01/2019;NIC
Niger;61292;5527;55765;2019;1;1;01/01/2019;NER
Nigeria;7661440;690874;6970566;2019;1;1;01/01/2019;NGA
Norway;23106902;2083675;21023227;2019;1;1;01/01/2019;NOR
Oman;3524262;317802;3206460;2019;1;1;01/01/2019;OMN
Pakistan;3524262;317802;3206460;2019;1;1;01/01/2019;PAK
Palau;30646;2763;27883;2019;1;1;01/01/2019;PLW
Panama;1379059;124358;1254701;2019;1;1;01/01/2019;PAN
Papua New Guinea;306458;27635;278823;2019;1;1;01/01/2019;PNG
Paraguay;490332;44216;446116;2019;1;1;01/01/2019;PRY
Peru;4658155;420051;4238104;2019;1;1;01/01/2019;PER
Philippines;6282380;566517;5715863;2019;1;1;01/01/2019;PHL
Poland;24577899;2216322;22361577;2019;1;1;01/01/2019;POL
Portugal;10726015;967223;9758792;2019;1;1;01/01/2019;PRT
Qatar;8642104;779305;7862799;2019;1;1;01/01/2019;QAT
Republic of Korea;69473936;6264842;63209094;2019;1;1;01/01/2019;KOR
Moldova;91937;8290;83647;2019;1;1;01/01/2019;MDA
Romania;6067860;547172;5520688;2019;1;1;01/01/2019;ROM
Russian Federation;73703050;6646205;67056845;2019;1;1;01/01/2019;RUS
Rwanda;91937;8290;83647;2019;1;1;01/01/2019;RWA
Saint Kitts and Nevis;30646;2763;27883;2019;1;1;01/01/2019;KN1
Saint Lucia;30646;2763;27883;2019;1;1;01/01/2019;LCA
Saint Vincent and the Grenadines;30646;2763;27883;2019;1;1;01/01/2019;VCT
Samoa;30646;2763;27883;2019;1;1;01/01/2019;WSM
San Marino;61292;5527;55765;2019;1;1;01/01/2019;SMR
Sao Tome and Principe;30646;2763;27883;2019;1;1;01/01/2019;STP
Saudi Arabia;35916829;3238816;32678013;2019;1;1;01/01/2019;SAU
Senegal;214520;19344;195176;2019;1;1;01/01/2019;SEN
Serbia;858081;77378;780703;2019;1;1;01/01/2019;SER
Seychelles;61292;5527;55765;2019;1;1;01/01/2019;SYC
Sierra Leone;30646;2763;27883;2019;1;1;01/01/2019;SLE
Singapore;14863193;1340295;13522898;2019;1;1;01/01/2019;SGP
Slovakia;4688801;422815;4265986;2019;1;1;01/01/2019;SVK
Slovenia;2329078;210026;2119052;2019;1;1;01/01/2019;SVN
Solomon Islands;30646;2763;27883;2019;1;1;01/01/2019;SLB
Somalia;30646;2763;27883;2019;1;1;01/01/2019;SOM
South Africa;8335646;751671;7583975;2019;1;1;01/01/2019;ZAF
South Sudan;183875;16581;167294;2019;1;1;01/01/2019;SSD
Spain;65765799;5930460;59835339;2019;1;1;01/01/2019;ESP
Sri Lanka;1348413;121594;1226819;2019;1;1;01/01/2019;LKA
Sudan;306458;27635;278823;2019;1;1;01/01/2019;SDN
Suriname;153229;13817;139412;2019;1;1;01/01/2019;SUR
Sweden;27765058;2503726;25261332;2019;1;1;01/01/2019;SWE
Switzerland;35273268;3180783;32092485;2019;1;1;01/01/2019;CHE
Syrian Arab Republic;337103;30398;306705;2019;1;1;01/01/2019;SYR
Tajikistan;122583;11054;111529;2019;1;1;01/01/2019;TJK
Thailand;9408248;848393;8559855;2019;1;1;01/01/2019;THA
North Macedonia;214520;19344;195176;2019;1;1;01/01/2019;MKD
Timor-Leste;61292;5527;55765;2019;1;1;01/01/2019;TMP
Togo;61292;5527;55765;2019;1;1;01/01/2019;TGO
Tonga;30646;2763;27883;2019;1;1;01/01/2019;TON
Trinidad and Tobago;1225830;110540;1115290;2019;1;1;01/01/2019;TTO
Tunisia;766144;69087;697057;2019;1;1;01/01/2019;TUN
Turkey;42015335;3788751;38226584;2019;1;1;01/01/2019;TUR
Turkmenistan;1011310;91196;920114;2019;1;1;01/01/2019;TKM
Tuvalu;30646;2763;27883;2019;1;1;01/01/2019;TUV
Uganda;245166;22108;223058;2019;1;1;01/01/2019;UGA
Ukraine;1746808;157520;1589288;2019;1;1;01/01/2019;UKR
United Arab Emirates;18877787;1702313;17175474;2019;1;1;01/01/2019;ARE
United Kingdom of Great Britain and  Northern Ireland;139959181;12620880;127338301;2019;1;1;01/01/2019;GBR
United Republic of Tanzania;306458;27635;278823;2019;1;1;01/01/2019;TZA
United States of America;674206698;–a;674206698;2019;1;1;01/01/2019;USA
Uruguay;2666181;240424;2425757;2019;1;1;01/01/2019;URY
Uzbekistan;980664;88432;892232;2019;1;1;01/01/2019;UZB
Vanuatu;30646;2763;27883;2019;1;1;01/01/2019;VUT
Venezuela;22310112;2011824;20298288;2019;1;1;01/01/2019;VEN
Viet Nam;2359723;212789;2146934;2019;1;1;01/01/2019;VNM
Yemen;306458;27635;278823;2019;1;1;01/01/2019;YEM
Zambia;275812;24871;250941;2019;1;1;01/01/2019;ZMB
Zimbabwe;153229;13817;139412;2019;1;1;01/01/2019;ZWE
Indonesia;16640647;1500578;15140069;2019;1;1;01/01/2019;IDN
Afghanistan;161288;15445;145843;2018;1;1;01/01/2018;AFG
Albania;215050;20594;194456;2018;1;1;01/01/2018;ALB
Algeria;4327886;414447;3913439;2018;1;1;01/01/2018;DZA
Andorra;161288;15445;145843;2018;1;1;01/01/2018;AND
Angola;268813;25742;243071;2018;1;1;01/01/2018;AGO
Antigua and Barbuda;53763;5148;48615;2018;1;1;01/01/2018;ATG
Argentina;23978100;2296193;21681907;2018;1;1;01/01/2018;ARG
Armenia;161288;15445;145843;2018;1;1;01/01/2018;ARM
Australia;62821546;6015923;56805623;2018;1;1;01/01/2018;AUS
Austria;19354520;1853430;17501090;2018;1;1;01/01/2018;AUT
Azerbaijan;1612877;154453;1458424;2018;1;1;01/01/2018;AZE
Bahamas;376338;36039;340299;2018;1;1;01/01/2018;BHS
Bahrain;1182776;113265;1069511;2018;1;1;01/01/2018;BHR
Bangladesh;268813;25742;243071;2018;1;1;01/01/2018;BGD
Barbados;188169;18019;170150;2018;1;1;01/01/2018;BRB
Belarus;1505352;144156;1361196;2018;1;1;01/01/2018;BLR
Belgium;23789931;2278174;21511757;2018;1;1;01/01/2018;BEL
Belize;26881;2574;24307;2018;1;1;01/01/2018;BLZ
Benin;80644;7723;72921;2018;1;1;01/01/2018;BEN
Bhutan;26881;2574;24307;2018;1;1;01/01/2018;BTN
Bolivia;322575;30890;291685;2018;1;1;01/01/2018;BOL
Bosnia and Herzegovina;349457;33465;315992;2018;1;1;01/01/2018;BIH
Botswana;376338;36039;340299;2018;1;1;01/01/2018;BWA
Brazil;102767125;9841195;92925930;2018;1;1;01/01/2018;BRA
Brunei Darussalam;779557;74652;704905;2018;1;1;01/01/2018;BRN
Bulgaria;1209657;115839;1093818;2018;1;1;01/01/2018;BGR
Burkina Faso;107525;10297;97228;2018;1;1;01/01/2018;BFA
Burundi;26881;2574;24307;2018;1;1;01/01/2018;BDI
Cape Verde;26881;2574;24307;2018;1;1;01/01/2018;CPV
Cambodia;107525;10297;97228;2018;1;1;01/01/2018;KHM
Cameroon;268813;25742;243071;2018;1;1;01/01/2018;CMR
Canada;78520213;7519260;71000953;2018;1;1;01/01/2018;CAN
Central African Republic;26881;2574;24307;2018;1;1;01/01/2018;CAF
Chad;134406;12871;121535;2018;1;1;01/01/2018;TCD
Chile;10725630;1027109;9698521;2018;1;1;01/01/2018;CHL
China;212926602;20390298;192536304;2018;1;1;01/01/2018;CHN
Colombia;8655771;828895;7826876;2018;1;1;01/01/2018;COL
Comoros;26881;2574;24307;2018;1;1;01/01/2018;COM
Congo;161288;15445;145843;2018;1;1;01/01/2018;COG
Costa Rica;1263420;120988;1142432;2018;1;1;01/01/2018;CRI
Côte d’Ivoire;241932;23168;218764;2018;1;1;01/01/2018;CIV
Croatia;2661247;254847;2406400;2018;1;1;01/01/2018;HRV
Cuba;1747283;167324;1579959;2018;1;1;01/01/2018;CUB
Cyprus;1155895;110691;1045204;2018;1;1;01/01/2018;CYP
Czech Republic;9247160;885527;8361633;2018;1;1;01/01/2018;CZE
Democratic People’s Republic of Korea;134406;12871;121535;2018;1;1;01/01/2018;PRK
Democratic Republic of the Congo;215050;20594;194456;2018;1;1;01/01/2018;ZAR
Denmark;15698666;1503337;14195329;2018;1;1;01/01/2018;DNK
Djibouti;26881;2574;24307;2018;1;1;01/01/2018;DJI
Dominica;26881;2574;24307;2018;1;1;01/01/2018;DMA
Dominican Republic;1236539;118414;1118125;2018;1;1;01/01/2018;DOM
Ecuador;1801046;172472;1628574;2018;1;1;01/01/2018;ECU
Egypt;4085954;391280;3694674;2018;1;1;01/01/2018;EGY
El Salvador;376338;36039;340299;2018;1;1;01/01/2018;SLV
Equatorial Guinea;268813;25742;243071;2018;1;1;01/01/2018;GNQ
Eritrea;26881;2574;24307;2018;1;1;01/01/2018;ERI
Estonia;1021489;97820;923669;2018;1;1;01/01/2018;EST
Ethiopia;268813;25742;243071;2018;1;1;01/01/2018;ETH
Fiji;80644;7723;72921;2018;1;1;01/01/2018;FJI
Finland;12257863;1173839;11084024;2018;1;1;01/01/2018;FIN
France;130616129;12508074;118108055;2018;1;1;01/01/2018;FRA
Gabon;456982;43762;413220;2018;1;1;01/01/2018;GAB
Gambia;26881;2574;24307;2018;1;1;01/01/2018;GMB
Georgia;215050;20594;194456;2018;1;1;01/01/2018;GEO
Germany;171744484;16446612;155297872;2018;1;1;01/01/2018;DEU
Ghana;430100;41187;388913;2018;1;1;01/01/2018;GHA
Greece;12661082;1212452;11448630;2018;1;1;01/01/2018;GRC
Grenada;26881;2574;24307;2018;1;1;01/01/2018;GRD
Guatemala;752676;72078;680598;2018;1;1;01/01/2018;GTM
Guinea;53763;5148;48615;2018;1;1;01/01/2018;GIN
Guinea-Bissau;26881;2574;24307;2018;1;1;01/01/2018;GNB
Guyana;53763;5148;48615;2018;1;1;01/01/2018;GUY
Haiti;80644;7723;72921;2018;1;1;01/01/2018;HTI
Honduras;215050;20594;194456;2018;1;1;01/01/2018;HND
Hungary;4327886;414447;3913439;2018;1;1;01/01/2018;HUN
Iceland;618269;59207;559062;2018;1;1;01/01/2018;ISL
India;19811502;1897191;17914311;2018;1;1;01/01/2018;IND
Iran (Islamic Republic of);12661082;1212452;11448630;2018;1;1;01/01/2018;IRN
Iraq;3467685;332073;3135612;2018;1;1;01/01/2018;IRQ
Ireland;9005228;862360;8142868;2018;1;1;01/01/2018;IRL
Israel;11558949;1106909;10452040;2018;1;1;01/01/2018;ISR
Italy;100751030;9648130;91102900;2018;1;1;01/01/2018;ITA
Jamaica;241932;23168;218764;2018;1;1;01/01/2018;JAM
Japan;260210770;24918329;235292441;2018;1;1;01/01/2018;JPN
Jordan;537626;51484;486142;2018;1;1;01/01/2018;JOR
Kazakhstan;5134324;491674;4642650;2018;1;1;01/01/2018;KAZ
Kenya;483863;46336;437527;2018;1;1;01/01/2018;KEN
Kiribati;26881;2574;24307;2018;1;1;01/01/2018;KIR
Kuwait;7661164;733649;6927515;2018;1;1;01/01/2018;KWT
Kyrgyzstan;53763;5148;48615;2018;1;1;01/01/2018;KGZ
Lao People’s Democratic Republic;80644;7723;72921;2018;1;1;01/01/2018;LAO
Latvia;1344064;128710;1215354;2018;1;1;01/01/2018;LVA
Lebanon;1236539;118414;1118125;2018;1;1;01/01/2018;LBN
Lesotho;26881;2574;24307;2018;1;1;01/01/2018;LSO
Liberia;26881;2574;24307;2018;1;1;01/01/2018;LBR
Libya;3360160;321776;3038384;2018;1;1;01/01/2018;LBY
Liechtenstein;188169;18019;170150;2018;1;1;01/01/2018;LIE
Lithuania;1935452;185343;1750109;2018;1;1;01/01/2018;LTU
Luxembourg;1720402;164749;1555653;2018;1;1;01/01/2018;LUX
Madagascar;80644;7723;72921;2018;1;1;01/01/2018;MDG
Malawi;53763;5148;48615;2018;1;1;01/01/2018;MWI
Malaysia;8655771;828895;7826876;2018;1;1;01/01/2018;MYS
Maldives;53763;5148;48615;2018;1;1;01/01/2018;MDV
Mali;80644;7723;72921;2018;1;1;01/01/2018;MLI
Malta;430100;41187;388913;2018;1;1;01/01/2018;MLT
Marshall Islands;26881;2574;24307;2018;1;1;01/01/2018;MHL
Mauritania;53763;5148;48615;2018;1;1;01/01/2018;MRT
Mauritius;322575;30890;291685;2018;1;1;01/01/2018;MUS
Mexico;38574634;3693988;34880646;2018;1;1;01/01/2018;MEX
Micronesia (Federated States of);26881;2574;24307;2018;1;1;01/01/2018;FSM
Monaco;268813;25742;243071;2018;1;1;01/01/2018;MCO
Mongolia;134406;12871;121535;2018;1;1;01/01/2018;MNG
Montenegro;107525;10297;97228;2018;1;1;01/01/2018;MNE
Morocco;1451589;139007;1312582;2018;1;1;01/01/2018;MAR
Mozambique;107525;10297;97228;2018;1;1;01/01/2018;MOZ
Myanmar;268813;25742;243071;2018;1;1;01/01/2018;MMR
Namibia;268813;25742;243071;2018;1;1;01/01/2018;NAM
Nauru;26881;2574;24307;2018;1;1;01/01/2018;NRU
Nepal;161288;15445;145843;2018;1;1;01/01/2018;NPL
Netherlands;39838054;3814976;36023078;2018;1;1;01/01/2018;NLD
New Zealand;7204182;689888;6514294;2018;1;1;01/01/2018;NZL
Nicaragua;107525;10297;97228;2018;1;1;01/01/2018;NIC
Niger;53763;5148;48615;2018;1;1;01/01/2018;NER
Nigeria;5618187;538009;5080178;2018;1;1;01/01/2018;NGA
Norway;22822205;2185502;20636703;2018;1;1;01/01/2018;NOR
Oman;3037584;290886;2746698;2018;1;1;01/01/2018;OMN
Pakistan;2499959;239401;2260558;2018;1;1;01/01/2018;PAK
Palau;26881;2574;24307;2018;1;1;01/01/2018;PLW
Panama;913963;87523;826440;2018;1;1;01/01/2018;PAN
Papua New Guinea;107525;10297;97228;2018;1;1;01/01/2018;PNG
Paraguay;376338;36039;340299;2018;1;1;01/01/2018;PRY
Peru;3655854;350092;3305762;2018;1;1;01/01/2018;PER
Philippines;4435411;424744;4010667;2018;1;1;01/01/2018;PHL
Poland;22607155;2164909;20442246;2018;1;1;01/01/2018;POL
Portugal;10537461;1009089;9528372;2018;1;1;01/01/2018;PRT
Qatar;7231064;692462;6538602;2018;1;1;01/01/2018;QAT
Republic of Korea;54810926;5248809;49562117;2018;1;1;01/01/2018;KOR
Moldova;107525;10297;97228;2018;1;1;01/01/2018;MDA
Romania;4946155;473654;4472501;2018;1;1;01/01/2018;ROM
Russian Federation;83009386;7949153;75060233;2018;1;1;01/01/2018;RUS
Rwanda;53763;5148;48615;2018;1;1;01/01/2018;RWA
Saint Kitts and Nevis;26881;2574;24307;2018;1;1;01/01/2018;KN1
Saint Lucia;26881;2574;24307;2018;1;1;01/01/2018;LCA
Saint Vincent and the Grenadines;26881;2574;24307;2018;1;1;01/01/2018;VCT
Samoa;26881;2574;24307;2018;1;1;01/01/2018;WSM
San Marino;80644;7723;72921;2018;1;1;01/01/2018;SMR
Sao Tome and Principe;26881;2574;24307;2018;1;1;01/01/2018;STP
Saudi Arabia;30805944;2950042;27855902;2018;1;1;01/01/2018;SAU
Senegal;134406;12871;121535;2018;1;1;01/01/2018;SEN
Serbia;860201;82375;777826;2018;1;1;01/01/2018;SER
Seychelles;26881;2574;24307;2018;1;1;01/01/2018;SYC
Sierra Leone;26881;2574;24307;2018;1;1;01/01/2018;SLE
Singapore;12015931;1150671;10865260;2018;1;1;01/01/2018;SGP
Slovakia;4301004;411873;3889131;2018;1;1;01/01/2018;SVK
Slovenia;2258027;216234;2041793;2018;1;1;01/01/2018;SVN
Solomon Islands;26881;2574;24307;2018;1;1;01/01/2018;SLB
Somalia;26881;2574;24307;2018;1;1;01/01/2018;SOM
South Africa;9784785;937012;8847773;2018;1;1;01/01/2018;ZAF
South Sudan;80644;7723;72921;2018;1;1;01/01/2018;SSD
Spain;65670962;6288789;59382173;2018;1;1;01/01/2018;ESP
Sri Lanka;833320;79801;753519;2018;1;1;01/01/2018;LKA
Sudan;268813;25742;243071;2018;1;1;01/01/2018;SDN
Suriname;161288;15445;145843;2018;1;1;01/01/2018;SUR
Swaziland;53763;5148;48615;2018;1;1;01/01/2018;SWZ
Sweden;25698502;2460942;23237560;2018;1;1;01/01/2018;SWE
Switzerland;30644657;2934597;27710060;2018;1;1;01/01/2018;CHE
Syrian Arab Republic;645151;61781;583370;2018;1;1;01/01/2018;SYR
Tajikistan;107525;10297;97228;2018;1;1;01/01/2018;TJK
Thailand;7822452;749094;7073358;2018;1;1;01/01/2018;THA
North Macedonia;188169;18019;170150;2018;1;1;01/01/2018;MKD
Timor-Leste;80644;7723;72921;2018;1;1;01/01/2018;TMP
Togo;26881;2574;24307;2018;1;1;01/01/2018;TGO
Tonga;26881;2574;24307;2018;1;1;01/01/2018;TON
Trinidad and Tobago;913963;87523;826440;2018;1;1;01/01/2018;TTO
Tunisia;752676;72078;680598;2018;1;1;01/01/2018;TUN
Turkey;27365141;2620543;24744598;2018;1;1;01/01/2018;TUR
Turkmenistan;698913;66930;631983;2018;1;1;01/01/2018;TKM
Tuvalu;26881;2574;24307;2018;1;1;01/01/2018;TUV
Uganda;241932;23168;218764;2018;1;1;01/01/2018;UGA
Ukraine;2768772;265143;2503629;2018;1;1;01/01/2018;UKR
United Arab Emirates;16236292;1554821;14681471;2018;1;1;01/01/2018;ARE
United Kingdom of Great Britain and  Northern Ireland;119971143;11488688;108482455;2018;1;1;01/01/2018;GBR
United Republic of Tanzania;268813;25742;243071;2018;1;1;01/01/2018;TZA
United States of America;591388114;–a;591388114;2018;1;1;01/01/2018;USA
Uruguay;2123621;203362;1920259;2018;1;1;01/01/2018;URY
Uzbekistan;618269;59207;559062;2018;1;1;01/01/2018;UZB
Vanuatu;26881;2574;24307;2018;1;1;01/01/2018;VUT
Venezuela;15349210;1469873;13879337;2018;1;1;01/01/2018;VEN
Viet Nam;1559114;149304;1409810;2018;1;1;01/01/2018;VNM
Yemen;268813;25742;243071;2018;1;1;01/01/2018;YEM
Zambia;188169;18019;170150;2018;1;1;01/01/2018;ZMB
Zimbabwe;107525;10297;97228;2018;1;1;01/01/2018;ZWE
Indonesia;13548164;1297401;12250763;2018;1;1;01/01/2018;IDN
Afghanistan;166592;15254;151338;2017;1;1;01/01/2017;AFG
Albania;222122;20339;201783;2017;1;1;01/01/2017;ALB
Algeria;4470213;409327;4060886;2017;1;1;01/01/2017;DZA
Andorra;166592;15254;151338;2017;1;1;01/01/2017;AND
Angola;277653;25424;252229;2017;1;1;01/01/2017;AGO
Antigua and Barbuda;55531;5085;50446;2017;1;1;01/01/2017;ATG
Argentina;24766647;2267822;22498825;2017;1;1;01/01/2017;ARG
Armenia;166592;15254;151338;2017;1;1;01/01/2017;ARM
Australia;64887504;5941591;58945913;2017;1;1;01/01/2017;AUS
Austria;19991015;1830529;18160486;2017;1;1;01/01/2017;AUT
Azerbaijan;1665918;152544;1513374;2017;1;1;01/01/2017;AZE
Bahamas;388714;35594;353120;2017;1;1;01/01/2017;BHS
Bahrain;1221673;111866;1109807;2017;1;1;01/01/2017;BHR
Bangladesh;277653;25424;252229;2017;1;1;01/01/2017;BGD
Barbados;194357;17797;176560;2017;1;1;01/01/2017;BRB
Belarus;1554857;142375;1412482;2017;1;1;01/01/2017;BLR
Belgium;24572290;2250025;22322265;2017;1;1;01/01/2017;BEL
Belize;27765;2542;25223;2017;1;1;01/01/2017;BLZ
Benin;83296;7627;75669;2017;1;1;01/01/2017;BEN
Bhutan;27765;2542;25223;2017;1;1;01/01/2017;BTN
Bolivia;333184;30509;302675;2017;1;1;01/01/2017;BOL
Bosnia and Herzegovina;360949;33051;327898;2017;1;1;01/01/2017;BIH
Botswana;388714;35594;353120;2017;1;1;01/01/2017;BWA
Brazil;106146738;9719599;96427139;2017;1;1;01/01/2017;BRA
Brunei Darussalam;805194;73730;731464;2017;1;1;01/01/2017;BRN
Bulgaria;1249439;114408;1135031;2017;1;1;01/01/2017;BGR
Burkina Faso;111061;10170;100891;2017;1;1;01/01/2017;BFA
Burundi;27765;2542;25223;2017;1;1;01/01/2017;BDI
Cape Verde;27765;2542;25223;2017;1;1;01/01/2017;CPV
Cambodia;111061;10170;100891;2017;1;1;01/01/2017;KHM
Cameroon;277653;25424;252229;2017;1;1;01/01/2017;CMR
Canada;81102438;7426354;73676084;2017;1;1;01/01/2017;CAN
Central African Republic;27765;2542;25223;2017;1;1;01/01/2017;CAF
Chad;138826;12712;126114;2017;1;1;01/01/2017;TCD
Chile;11078354;1014418;10063936;2017;1;1;01/01/2017;CHL
China;219928933;20138358;199790575;2017;1;1;01/01/2017;CHN
Colombia;8940426;818653;8121773;2017;1;1;01/01/2017;COL
Comoros;27765;2542;25223;2017;1;1;01/01/2017;COM
Congo;166592;15254;151338;2017;1;1;01/01/2017;COG
Costa Rica;1304969;119493;1185476;2017;1;1;01/01/2017;CRI
Côte d’Ivoire;249888;22882;227006;2017;1;1;01/01/2017;CIV
Croatia;2748765;251698;2497067;2017;1;1;01/01/2017;HRV
Cuba;1804745;165256;1639489;2017;1;1;01/01/2017;CUB
Cyprus;1193908;109323;1084585;2017;1;1;01/01/2017;CYP
Czech Republic;9551263;874586;8676677;2017;1;1;01/01/2017;CZE
Democratic People’s Republic of Korea;138826;12712;126114;2017;1;1;01/01/2017;PRK
Democratic Republic of the Congo;222122;20339;201783;2017;1;1;01/01/2017;ZAR
Denmark;16214935;1484762;14730173;2017;1;1;01/01/2017;DNK
Djibouti;27765;2542;25223;2017;1;1;01/01/2017;DJI
Dominica;27765;2542;25223;2017;1;1;01/01/2017;DMA
Dominican Republic;1277204;116950;1160254;2017;1;1;01/01/2017;DOM
Ecuador;1860275;170341;1689934;2017;1;1;01/01/2017;ECU
Egypt;4220326;386445;3833881;2017;1;1;01/01/2017;EGY
El Salvador;388714;35594;353120;2017;1;1;01/01/2017;SLV
Equatorial Guinea;277653;25424;252229;2017;1;1;01/01/2017;GNQ
Eritrea;27765;2542;25223;2017;1;1;01/01/2017;ERI
Estonia;1055081;96611;958470;2017;1;1;01/01/2017;EST
Ethiopia;277653;25424;252229;2017;1;1;01/01/2017;ETH
Fiji;83296;7627;75669;2017;1;1;01/01/2017;FJI
Finland;12660976;1159335;11501641;2017;1;1;01/01/2017;FIN
France;134911588;12353527;122558061;2017;1;1;01/01/2017;FRA
Gabon;472010;43221;428789;2017;1;1;01/01/2017;GAB
Gambia;27765;2542;25223;2017;1;1;01/01/2017;GMB
Georgia;222122;20339;201783;2017;1;1;01/01/2017;GEO
Germany;177392495;16243400;161149095;2017;1;1;01/01/2017;DEU
Ghana;444245;40678;403567;2017;1;1;01/01/2017;GHA
Greece;13077456;1197471;11879985;2017;1;1;01/01/2017;GRC
Grenada;27765;2542;25223;2017;1;1;01/01/2017;GRD
Guatemala;777428;71187;706241;2017;1;1;01/01/2017;GTM
Guinea;55531;5085;50446;2017;1;1;01/01/2017;GIN
Guinea-Bissau;27765;2542;25223;2017;1;1;01/01/2017;GNB
Guyana;55531;5085;50446;2017;1;1;01/01/2017;GUY
Haiti;83296;7627;75669;2017;1;1;01/01/2017;HTI
Honduras;222122;20339;201783;2017;1;1;01/01/2017;HND
Hungary;4470213;409327;4060886;2017;1;1;01/01/2017;HUN
Iceland;638602;58475;580127;2017;1;1;01/01/2017;ISL
India;20463025;1873750;18589275;2017;1;1;01/01/2017;IND
Iran (Islamic Republic of);13077456;1197471;11879985;2017;1;1;01/01/2017;IRN
Iraq;3581724;327970;3253754;2017;1;1;01/01/2017;IRQ
Ireland;9301375;851705;8449670;2017;1;1;01/01/2017;IRL
Israel;11939079;1093233;10845846;2017;1;1;01/01/2017;ISR
Italy;104064341;9528919;94535422;2017;1;1;01/01/2017;ITA
Jamaica;249888;22882;227006;2017;1;1;01/01/2017;JAM
Japan;268768094;24610442;244157652;2017;1;1;01/01/2017;JPN
Jordan;555306;50848;504458;2017;1;1;01/01/2017;JOR
Kazakhstan;5303172;485599;4817573;2017;1;1;01/01/2017;KAZ
Kenya;499776;45763;454013;2017;1;1;01/01/2017;KEN
Kiribati;27765;2542;25223;2017;1;1;01/01/2017;KIR
Kuwait;7913110;724584;7188526;2017;1;1;01/01/2017;KWT
Kyrgyzstan;55531;5085;50446;2017;1;1;01/01/2017;KGZ
Lao People’s Democratic Republic;83296;7627;75669;2017;1;1;01/01/2017;LAO
Latvia;1388265;127120;1261145;2017;1;1;01/01/2017;LVA
Lebanon;1277204;116950;1160254;2017;1;1;01/01/2017;LBN
Lesotho;27765;2542;25223;2017;1;1;01/01/2017;LSO
Liberia;27765;2542;25223;2017;1;1;01/01/2017;LBR
Libya;3470663;317800;3152863;2017;1;1;01/01/2017;LBY
Liechtenstein;194357;17797;176560;2017;1;1;01/01/2017;LIE
Lithuania;1999102;183053;1816049;2017;1;1;01/01/2017;LTU
Luxembourg;1776979;162714;1614265;2017;1;1;01/01/2017;LUX
Madagascar;83296;7627;75669;2017;1;1;01/01/2017;MDG
Malawi;55531;5085;50446;2017;1;1;01/01/2017;MWI
Malaysia;8940426;818653;8121773;2017;1;1;01/01/2017;MYS
Maldives;55531;5085;50446;2017;1;1;01/01/2017;MDV
Mali;83296;7627;75669;2017;1;1;01/01/2017;MLI
Malta;444245;40678;403567;2017;1;1;01/01/2017;MLT
Marshall Islands;27765;2542;25223;2017;1;1;01/01/2017;MHL
Mauritania;55531;5085;50446;2017;1;1;01/01/2017;MRT
Mauritius;333184;30509;302675;2017;1;1;01/01/2017;MUS
Mexico;39843204;3648346;36194858;2017;1;1;01/01/2017;MEX
Micronesia (Federated States of);27765;2542;25223;2017;1;1;01/01/2017;FSM
Monaco;277653;25424;252229;2017;1;1;01/01/2017;MCO
Mongolia;138826;12712;126114;2017;1;1;01/01/2017;MNG
Montenegro;111061;10170;100891;2017;1;1;01/01/2017;MNE
Morocco;1499326;137290;1362036;2017;1;1;01/01/2017;MAR
Mozambique;111061;10170;100891;2017;1;1;01/01/2017;MOZ
Myanmar;277653;25424;252229;2017;1;1;01/01/2017;MMR
Namibia;277653;25424;252229;2017;1;1;01/01/2017;NAM
Nauru;27765;2542;25223;2017;1;1;01/01/2017;NRU
Nepal;166592;15254;151338;2017;1;1;01/01/2017;NPL
Netherlands;41148173;3767838;37380335;2017;1;1;01/01/2017;NLD
New Zealand;7441100;681364;6759736;2017;1;1;01/01/2017;NZL
Nicaragua;111061;10170;100891;2017;1;1;01/01/2017;NIC
Niger;55531;5085;50446;2017;1;1;01/01/2017;NER
Nigeria;5802948;531362;5271586;2017;1;1;01/01/2017;NGA
Norway;23572739;2158499;21414240;2017;1;1;01/01/2017;NOR
Oman;3137479;287291;2850188;2017;1;1;01/01/2017;OMN
Pakistan;2582173;236443;2345730;2017;1;1;01/01/2017;PAK
Palau;27765;2542;25223;2017;1;1;01/01/2017;PLW
Panama;944020;86442;857578;2017;1;1;01/01/2017;PAN
Papua New Guinea;111061;10170;100891;2017;1;1;01/01/2017;PNG
Paraguay;388714;35594;353120;2017;1;1;01/01/2017;PRY
Peru;3776081;345767;3430314;2017;1;1;01/01/2017;PER
Philippines;4581274;419496;4161778;2017;1;1;01/01/2017;PHL
Poland;23350617;2138159;21212458;2017;1;1;01/01/2017;POL
Portugal;10883997;996621;9887376;2017;1;1;01/01/2017;PRT
Qatar;7468866;683906;6784960;2017;1;1;01/01/2017;QAT
Republic of Korea;56613445;5183956;51429489;2017;1;1;01/01/2017;KOR
Moldova;111061;10170;100891;2017;1;1;01/01/2017;MDA
Romania;5108815;467802;4641013;2017;1;1;01/01/2017;ROM
Russian Federation;85739243;7850934;77888309;2017;1;1;01/01/2017;RUS
Rwanda;55531;5085;50446;2017;1;1;01/01/2017;RWA
Saint Kitts and Nevis;27765;2542;25223;2017;1;1;01/01/2017;KN1
Saint Lucia;27765;2542;25223;2017;1;1;01/01/2017;LCA
Saint Vincent and the Grenadines;27765;2542;25223;2017;1;1;01/01/2017;VCT
Samoa;27765;2542;25223;2017;1;1;01/01/2017;WSM
San Marino;83296;7627;75669;2017;1;1;01/01/2017;SMR
Sao Tome and Principe;27765;2542;25223;2017;1;1;01/01/2017;STP
Saudi Arabia;31819033;2913592;28905441;2017;1;1;01/01/2017;SAU
Senegal;138826;12712;126114;2017;1;1;01/01/2017;SEN
Serbia;888490;81357;807133;2017;1;1;01/01/2017;SER
Seychelles;27765;2542;25223;2017;1;1;01/01/2017;SYC
Sierra Leone;27765;2542;25223;2017;1;1;01/01/2017;SLE
Singapore;12411089;1136453;11274636;2017;1;1;01/01/2017;SGP
Slovakia;4442448;406784;4035664;2017;1;1;01/01/2017;SVK
Slovenia;2332285;213562;2118723;2017;1;1;01/01/2017;SVN
Solomon Islands;27765;2542;25223;2017;1;1;01/01/2017;SLB
Somalia;27765;2542;25223;2017;1;1;01/01/2017;SOM
South Africa;10106569;925434;9181135;2017;1;1;01/01/2017;ZAF
South Sudan;83296;7627;75669;2017;1;1;01/01/2017;SSD
Spain;67830626;6211086;61619540;2017;1;1;01/01/2017;ESP
Sri Lanka;860724;78815;781909;2017;1;1;01/01/2017;LKA
Sudan;277653;25424;252229;2017;1;1;01/01/2017;SDN
Suriname;166592;15254;151338;2017;1;1;01/01/2017;SUR
Swaziland;55531;5085;50446;2017;1;1;01/01/2017;SWZ
Sweden;26543626;2430536;24113090;2017;1;1;01/01/2017;SWE
Switzerland;31652441;2898337;28754104;2017;1;1;01/01/2017;CHE
Syrian Arab Republic;666367;61018;605349;2017;1;1;01/01/2017;SYR
Tajikistan;111061;10170;100891;2017;1;1;01/01/2017;TJK
Thailand;8079702;739839;7339863;2017;1;1;01/01/2017;THA
North Macedonia;194357;17797;176560;2017;1;1;01/01/2017;MKD
Timor-Leste;83296;7627;75669;2017;1;1;01/01/2017;TMP
Togo;27765;2542;25223;2017;1;1;01/01/2017;TGO
Tonga;27765;2542;25223;2017;1;1;01/01/2017;TON
Trinidad and Tobago;944020;86442;857578;2017;1;1;01/01/2017;TTO
Tunisia;777428;71187;706241;2017;1;1;01/01/2017;TUN
Turkey;28265074;2588164;25676910;2017;1;1;01/01/2017;TUR
Turkmenistan;721898;66103;655795;2017;1;1;01/01/2017;TKM
Tuvalu;27765;2542;25223;2017;1;1;01/01/2017;TUV
Uganda;249888;22882;227006;2017;1;1;01/01/2017;UGA
Ukraine;2859826;261867;2597959;2017;1;1;01/01/2017;UKR
United Arab Emirates;16770241;1535610;15234631;2017;1;1;01/01/2017;ARE
United Kingdom of Great Britain and  Northern Ireland;123916530;11346736;112569794;2017;1;1;01/01/2017;GBR
United Republic of Tanzania;277653;25424;252229;2017;1;1;01/01/2017;TZA
United States of America;610836578;–a;610836578;2017;1;1;01/01/2017;USA
Uruguay;2193459;200850;1992609;2017;1;1;01/01/2017;URY
Uzbekistan;638602;58475;580127;2017;1;1;01/01/2017;UZB
Vanuatu;27765;2542;25223;2017;1;1;01/01/2017;VUT
Venezuela;15853986;1451711;14402275;2017;1;1;01/01/2017;VEN
Viet Nam;1610387;147459;1462928;2017;1;1;01/01/2017;VNM
Yemen;277653;25424;252229;2017;1;1;01/01/2017;YEM
Zambia;194357;17797;176560;2017;1;1;01/01/2017;ZMB
Zimbabwe;111061;10170;100891;2017;1;1;01/01/2017;ZWE
Indonesia;13993711;1281370;12712341;2017;1;1;01/01/2017;IDN
Afghanistan;162011;15122;146889;2016;1;1;01/01/2016;AFG
Albania;216015;20163;195852;2016;1;1;01/01/2016;ALB
Algeria;4347303;405783;3941520;2016;1;1;01/01/2016;DZA
Andorra;162011;15122;146889;2016;1;1;01/01/2016;AND
Angola;270019;25204;244815;2016;1;1;01/01/2016;AGO
Antigua and Barbuda;54004;5041;48963;2016;1;1;01/01/2016;ATG
Argentina;24085678;2248187;21837491;2016;1;1;01/01/2016;ARG
Armenia;162011;15122;146889;2016;1;1;01/01/2016;ARM
Australia;63103396;5890149;57213247;2016;1;1;01/01/2016;AUS
Austria;19441354;1814680;17626674;2016;1;1;01/01/2016;AUT
Azerbaijan;1620113;151224;1468889;2016;1;1;01/01/2016;AZE
Bahamas;378026;35285;342741;2016;1;1;01/01/2016;BHS
Bahrain;1188083;110897;1077186;2016;1;1;01/01/2016;BHR
Bangladesh;270019;25204;244815;2016;1;1;01/01/2016;BGD
Barbados;189013;17643;171370;2016;1;1;01/01/2016;BRB
Belarus;1512105;141142;1370963;2016;1;1;01/01/2016;BLR
Belgium;23896665;2230544;21666121;2016;1;1;01/01/2016;BEL
Belize;27002;2520;24482;2016;1;1;01/01/2016;BLZ
Benin;81006;7561;73445;2016;1;1;01/01/2016;BEN
Bhutan;27002;2520;24482;2016;1;1;01/01/2016;BTN
Bolivia;324023;30245;293778;2016;1;1;01/01/2016;BOL
Bosnia and Herzegovina;351024;32765;318259;2016;1;1;01/01/2016;BIH
Botswana;378026;35285;342741;2016;1;1;01/01/2016;BWA
Brazil;103228191;9635447;93592744;2016;1;1;01/01/2016;BRA
Brunei Darussalam;783054;73091;709963;2016;1;1;01/01/2016;BRN
Bulgaria;1215084;113418;1101666;2016;1;1;01/01/2016;BGR
Burkina Faso;108008;10082;97926;2016;1;1;01/01/2016;BFA
Burundi;27002;2520;24482;2016;1;1;01/01/2016;BDI
Cape Verde;27002;2520;24482;2016;1;1;01/01/2016;CPV
Cambodia;108008;10082;97926;2016;1;1;01/01/2016;KHM
Cameroon;270019;25204;244815;2016;1;1;01/01/2016;CMR
Canada;78872494;7362056;71510438;2016;1;1;01/01/2016;CAN
Central African Republic;27002;2520;24482;2016;1;1;01/01/2016;CAF
Chad;135009;12602;122407;2016;1;1;01/01/2016;TCD
Chile;10773750;1005635;9768115;2016;1;1;01/01/2016;CHL
China;213881899;19964001;193917898;2016;1;1;01/01/2016;CHN
Colombia;8694606;811565;7883041;2016;1;1;01/01/2016;COL
Comoros;27002;2520;24482;2016;1;1;01/01/2016;COM
Congo;162011;15122;146889;2016;1;1;01/01/2016;COG
Costa Rica;1269088;118458;1150630;2016;1;1;01/01/2016;CRI
Côte d’Ivoire;243017;22684;220333;2016;1;1;01/01/2016;CIV
Croatia;2673186;249519;2423667;2016;1;1;01/01/2016;HRV
Cuba;1755122;163825;1591297;2016;1;1;01/01/2016;CUB
Cyprus;1161081;108377;1052704;2016;1;1;01/01/2016;CYP
Czech Republic;9288647;867014;8421633;2016;1;1;01/01/2016;CZE
Democratic People’s Republic of Korea;135009;12602;122407;2016;1;1;01/01/2016;PRK
Democratic Republic of the Congo;216015;20163;195852;2016;1;1;01/01/2016;ZAR
Denmark;15769098;1471907;14297191;2016;1;1;01/01/2016;DNK
Djibouti;27002;2520;24482;2016;1;1;01/01/2016;DJI
Dominica;27002;2520;24482;2016;1;1;01/01/2016;DMA
Dominican Republic;1242087;115938;1126149;2016;1;1;01/01/2016;DOM
Ecuador;1809126;168866;1640260;2016;1;1;01/01/2016;ECU
Egypt;4104286;383099;3721187;2016;1;1;01/01/2016;EGY
El Salvador;378026;35285;342741;2016;1;1;01/01/2016;SLV
Equatorial Guinea;270019;25204;244815;2016;1;1;01/01/2016;GNQ
Eritrea;27002;2520;24482;2016;1;1;01/01/2016;ERI
Estonia;1026071;95775;930296;2016;1;1;01/01/2016;EST
Ethiopia;270019;25204;244815;2016;1;1;01/01/2016;ETH
Fiji;81006;7561;73445;2016;1;1;01/01/2016;FJI
Finland;12312858;1149298;11163560;2016;1;1;01/01/2016;FIN
France;131202140;12246570;118955570;2016;1;1;01/01/2016;FRA
Gabon;459032;42847;416185;2016;1;1;01/01/2016;GAB
Gambia;27002;2520;24482;2016;1;1;01/01/2016;GMB
Georgia;216015;20163;195852;2016;1;1;01/01/2016;GEO
Germany;172515018;16102766;156412252;2016;1;1;01/01/2016;DEU
Ghana;432030;40326;391704;2016;1;1;01/01/2016;GHA
Greece;12717886;1187103;11530783;2016;1;1;01/01/2016;GRC
Grenada;27002;2520;24482;2016;1;1;01/01/2016;GRD
Guatemala;756053;70571;685482;2016;1;1;01/01/2016;GTM
Guinea;54004;5041;48963;2016;1;1;01/01/2016;GIN
Guinea-Bissau;27002;2520;24482;2016;1;1;01/01/2016;GNB
Guyana;54004;5041;48963;2016;1;1;01/01/2016;GUY
Haiti;81006;7561;73445;2016;1;1;01/01/2016;HTI
Honduras;216015;20163;195852;2016;1;1;01/01/2016;HND
Hungary;4347303;405783;3941520;2016;1;1;01/01/2016;HUN
Iceland;621043;57969;563074;2016;1;1;01/01/2016;ISL
India;19900386;1857527;18042859;2016;1;1;01/01/2016;IND
Iran (Islamic Republic of);12717886;1187103;11530783;2016;1;1;01/01/2016;IRN
Iraq;3483242;325130;3158112;2016;1;1;01/01/2016;IRQ
Ireland;9045630;844331;8201299;2016;1;1;01/01/2016;IRL
Israel;11610809;1083767;10527042;2016;1;1;01/01/2016;ISR
Italy;101203050;9446418;91756632;2016;1;1;01/01/2016;ITA
Jamaica;243017;22684;220333;2016;1;1;01/01/2016;JAM
Japan;261378208;24397366;236980842;2016;1;1;01/01/2016;JPN
Jordan;540037;50408;489629;2016;1;1;01/01/2016;JOR
Kazakhstan;5157359;481395;4675964;2016;1;1;01/01/2016;KAZ
Kenya;486034;45367;440667;2016;1;1;01/01/2016;KEN
Kiribati;27002;2520;24482;2016;1;1;01/01/2016;KIR
Kuwait;7695536;718311;6977225;2016;1;1;01/01/2016;KWT
Kyrgyzstan;54004;5041;48963;2016;1;1;01/01/2016;KGZ
Lao People’s Democratic Republic;81006;7561;73445;2016;1;1;01/01/2016;LAO
Latvia;1350094;126020;1224074;2016;1;1;01/01/2016;LVA
Lebanon;1242087;115938;1126149;2016;1;1;01/01/2016;LBN
Lesotho;27002;2520;24482;2016;1;1;01/01/2016;LSO
Liberia;27002;2520;24482;2016;1;1;01/01/2016;LBR
Libya;3375235;315049;3060186;2016;1;1;01/01/2016;LBY
Liechtenstein;189013;17643;171370;2016;1;1;01/01/2016;LIE
Lithuania;1944135;181468;1762667;2016;1;1;01/01/2016;LTU
Luxembourg;1728120;161305;1566815;2016;1;1;01/01/2016;LUX
Madagascar;81006;7561;73445;2016;1;1;01/01/2016;MDG
Malawi;54004;5041;48963;2016;1;1;01/01/2016;MWI
Malaysia;8694606;811565;7883041;2016;1;1;01/01/2016;MYS
Maldives;54004;5041;48963;2016;1;1;01/01/2016;MDV
Mali;81006;7561;73445;2016;1;1;01/01/2016;MLI
Malta;432030;40326;391704;2016;1;1;01/01/2016;MLT
Marshall Islands;27002;2520;24482;2016;1;1;01/01/2016;MHL
Mauritania;54004;5041;48963;2016;1;1;01/01/2016;MRT
Mauritius;324023;30245;293778;2016;1;1;01/01/2016;MUS
Mexico;38747699;3616758;35130941;2016;1;1;01/01/2016;MEX
Micronesia (Federated States of);27002;2520;24482;2016;1;1;01/01/2016;FSM
Monaco;270019;25204;244815;2016;1;1;01/01/2016;MCO
Mongolia;135009;12602;122407;2016;1;1;01/01/2016;MNG
Montenegro;108008;10082;97926;2016;1;1;01/01/2016;MNE
Morocco;1458101;136101;1322000;2016;1;1;01/01/2016;MAR
Mozambique;108008;10082;97926;2016;1;1;01/01/2016;MOZ
Myanmar;270019;25204;244815;2016;1;1;01/01/2016;MMR
Namibia;270019;25204;244815;2016;1;1;01/01/2016;NAM
Nauru;27002;2520;24482;2016;1;1;01/01/2016;NRU
Nepal;162011;15122;146889;2016;1;1;01/01/2016;NPL
Netherlands;40016787;3735216;36281571;2016;1;1;01/01/2016;NLD
New Zealand;7236504;675464;6561040;2016;1;1;01/01/2016;NZL
Nicaragua;108008;10082;97926;2016;1;1;01/01/2016;NIC
Niger;54004;5041;48963;2016;1;1;01/01/2016;NER
Nigeria;5643393;526762;5116631;2016;1;1;01/01/2016;NGA
Norway;22924597;2139810;20784787;2016;1;1;01/01/2016;NOR
Oman;3051212;284804;2766408;2016;1;1;01/01/2016;OMN
Pakistan;2511175;234396;2276779;2016;1;1;01/01/2016;PAK
Palau;27002;2520;24482;2016;1;1;01/01/2016;PLW
Panama;918064;85693;832371;2016;1;1;01/01/2016;PAN
Papua New Guinea;108008;10082;97926;2016;1;1;01/01/2016;PNG
Paraguay;378026;35285;342741;2016;1;1;01/01/2016;PRY
Peru;3672256;342773;3329483;2016;1;1;01/01/2016;PER
Philippines;4455310;415864;4039446;2016;1;1;01/01/2016;PHL
Poland;22708582;2119647;20588935;2016;1;1;01/01/2016;POL
Portugal;10584737;987993;9596744;2016;1;1;01/01/2016;PRT
Qatar;7263506;677985;6585521;2016;1;1;01/01/2016;QAT
Republic of Korea;55056835;5139073;49917762;2016;1;1;01/01/2016;KOR
Moldova;108008;10082;97926;2016;1;1;01/01/2016;MDA
Romania;4968346;463752;4504594;2016;1;1;01/01/2016;ROM
Russian Federation;83381808;7782961;75598847;2016;1;1;01/01/2016;RUS
Rwanda;54004;5041;48963;2016;1;1;01/01/2016;RWA
Saint Kitts and Nevis;27002;2520;24482;2016;1;1;01/01/2016;KN1
Saint Lucia;27002;2520;24482;2016;1;1;01/01/2016;LCA
Saint Vincent and the Grenadines;27002;2520;24482;2016;1;1;01/01/2016;VCT
Samoa;27002;2520;24482;2016;1;1;01/01/2016;WSM
San Marino;81006;7561;73445;2016;1;1;01/01/2016;SMR
Sao Tome and Principe;27002;2520;24482;2016;1;1;01/01/2016;STP
Saudi Arabia;30944155;2888366;28055789;2016;1;1;01/01/2016;SAU
Senegal;135009;12602;122407;2016;1;1;01/01/2016;SEN
Serbia;864060;80653;783407;2016;1;1;01/01/2016;SER
Seychelles;27002;2520;24482;2016;1;1;01/01/2016;SYC
Sierra Leone;27002;2520;24482;2016;1;1;01/01/2016;SLE
Singapore;12069841;1126614;10943227;2016;1;1;01/01/2016;SGP
Slovakia;4320301;403262;3917039;2016;1;1;01/01/2016;SVK
Slovenia;2268158;211713;2056445;2016;1;1;01/01/2016;SVN
Solomon Islands;27002;2520;24482;2016;1;1;01/01/2016;SLB
Somalia;27002;2520;24482;2016;1;1;01/01/2016;SOM
South Africa;9828684;917422;8911262;2016;1;1;01/01/2016;ZAF
South Sudan;81006;7561;73445;2016;1;1;01/01/2016;SSD
Spain;65965595;6157311;59808284;2016;1;1;01/01/2016;ESP
Sri Lanka;837058;78132;758926;2016;1;1;01/01/2016;LKA
Sudan;270019;25204;244815;2016;1;1;01/01/2016;SDN
Suriname;162011;15122;146889;2016;1;1;01/01/2016;SUR
Swaziland;54004;5041;48963;2016;1;1;01/01/2016;SWZ
Sweden;25813798;2409492;23404306;2016;1;1;01/01/2016;SWE
Switzerland;30782144;2873244;27908900;2016;1;1;01/01/2016;CHE
Syrian Arab Republic;648045;60490;587555;2016;1;1;01/01/2016;SYR
Tajikistan;108008;10082;97926;2016;1;1;01/01/2016;TJK
Thailand;7857547;733433;7124114;2016;1;1;01/01/2016;THA
North Macedonia;189013;17643;171370;2016;1;1;01/01/2016;MKD
Timor-Leste;81006;7561;73445;2016;1;1;01/01/2016;TMP
Togo;27002;2520;24482;2016;1;1;01/01/2016;TGO
Tonga;27002;2520;24482;2016;1;1;01/01/2016;TON
Trinidad and Tobago;918064;85693;832371;2016;1;1;01/01/2016;TTO
Tunisia;756053;70571;685482;2016;1;1;01/01/2016;TUN
Turkey;27487915;2565756;24922159;2016;1;1;01/01/2016;TUR
Turkmenistan;702049;65530;636519;2016;1;1;01/01/2016;TKM
Tuvalu;27002;2520;24482;2016;1;1;01/01/2016;TUV
Uganda;243017;22684;220333;2016;1;1;01/01/2016;UGA
Ukraine;2781194;259600;2521594;2016;1;1;01/01/2016;UKR
United Arab Emirates;16309136;1522315;14786821;2016;1;1;01/01/2016;ARE
United Kingdom of Great Britain and  Northern Ireland;120509395;11248496;109260899;2016;1;1;01/01/2016;GBR
United Republic of Tanzania;270019;25204;244815;2016;1;1;01/01/2016;TZA
United States of America;594041382;a;594041382;2016;1;1;01/01/2016;USA
Uruguay;2133148;199111;1934037;2016;1;1;01/01/2016;URY
Uzbekistan;621043;57969;563074;2016;1;1;01/01/2016;UZB
Vanuatu;27002;2520;24482;2016;1;1;01/01/2016;VUT
Venezuela;15418074;1439142;13978932;2016;1;1;01/01/2016;VEN
Viet Nam;1566109;146183;1419926;2016;1;1;01/01/2016;VNM
Yemen;270019;25204;244815;2016;1;1;01/01/2016;YEM
Zambia;189013;17643;171370;2016;1;1;01/01/2016;ZMB
Zimbabwe;108008;10082;97926;2016;1;1;01/01/2016;ZWE
Indonesia;13608948;1270276;12338672;2016;1;1;01/01/2016;IDN
Afghanistan;148813;13135;135678;2015;1;1;01/01/2015;AFG
Albania;297627;26270;271357;2015;1;1;01/01/2015;ALB
Algeria;4077487;359904;3717583;2015;1;1;01/01/2015;DZA
Andorra;238101;21016;217085;2015;1;1;01/01/2015;AND
Angola;297627;26270;271357;2015;1;1;01/01/2015;AGO
Antigua and Barbuda;59525;5254;54271;2015;1;1;01/01/2015;ATG
Argentina;12857477;1134878;11722599;2015;1;1;01/01/2015;ARG
Armenia;208339;18389;189950;2015;1;1;01/01/2015;ARM
Australia;61727796;5448467;56279329;2015;1;1;01/01/2015;AUS
Austria;23750618;2096372;21654246;2015;1;1;01/01/2015;AUT
Azerbaijan;1190507;105081;1085426;2015;1;1;01/01/2015;AZE
Bahamas;505965;44660;461305;2015;1;1;01/01/2015;BHS
Bahrain;1160744;102454;1058290;2015;1;1;01/01/2015;BHR
Bangladesh;297627;26270;271357;2015;1;1;01/01/2015;BGD
Barbados;238101;21016;217085;2015;1;1;01/01/2015;BRB
Belarus;1666710;147114;1519596;2015;1;1;01/01/2015;BLR
Belgium;29703154;2621779;27081375;2015;1;1;01/01/2015;BEL
Belize;29763;2627;27136;2015;1;1;01/01/2015;BLZ
Benin;89288;7881;81407;2015;1;1;01/01/2015;BEN
Bhutan;29763;2627;27136;2015;1;1;01/01/2015;BTN
Bolivia;267864;23643;244221;2015;1;1;01/01/2015;BOL
Bosnia and Herzegovina;505965;44660;461305;2015;1;1;01/01/2015;BIH
Botswana;505965;44660;461305;2015;1;1;01/01/2015;BWA
Brazil;87323700;7707715;79615985;2015;1;1;01/01/2015;BRA
Brunei Darussalam;773830;68303;705527;2015;1;1;01/01/2015;BRN
Bulgaria;1398846;123471;1275375;2015;1;1;01/01/2015;BGR
Burkina Faso;89288;7881;81407;2015;1;1;01/01/2015;BFA
Burundi;29763;2627;27136;2015;1;1;01/01/2015;BDI
Cape Verde;29763;2627;27136;2015;1;1;01/01/2015;CPV
Cambodia;119051;10508;108543;2015;1;1;01/01/2015;KHM
Cameroon;357152;31524;325628;2015;1;1;01/01/2015;CMR
Canada;88811834;7839067;80972767;2015;1;1;01/01/2015;CAN
Central African Republic;29763;2627;27136;2015;1;1;01/01/2015;CAF
Chad;59525;5254;54271;2015;1;1;01/01/2015;TCD
Chile;9940735;877429;9063306;2015;1;1;01/01/2015;CHL
China;153218271;13523966;139694305;2015;1;1;01/01/2015;CHN
Colombia;7708534;680402;7028132;2015;1;1;01/01/2015;COL
Comoros;29763;2627;27136;2015;1;1;01/01/2015;COM
Congo;148813;13135;135678;2015;1;1;01/01/2015;COG
Costa Rica;1130982;99827;1031155;2015;1;1;01/01/2015;CRI
Côte d’Ivoire;327389;28897;298492;2015;1;1;01/01/2015;CIV
Croatia;3750097;331006;3419091;2015;1;1;01/01/2015;HRV
Cuba;2053625;181265;1872360;2015;1;1;01/01/2015;CUB
Cyprus;1398846;123471;1275375;2015;1;1;01/01/2015;CYP
Czech Republic;11488394;1014035;10474359;2015;1;1;01/01/2015;CZE
Democratic People’s Republic of Korea;178576;15762;162814;2015;1;1;01/01/2015;PRK
Democratic Republic of the Congo;89288;7881;81407;2015;1;1;01/01/2015;ZAR
Denmark;20089808;1773247;18316561;2015;1;1;01/01/2015;DNK
Djibouti;29763;2627;27136;2015;1;1;01/01/2015;DJI
Dominica;29763;2627;27136;2015;1;1;01/01/2015;DMA
Dominican Republic;1339320;118217;1221103;2015;1;1;01/01/2015;DOM
Ecuador;1309558;115590;1193968;2015;1;1;01/01/2015;ECU
Egypt;3988199;352023;3636176;2015;1;1;01/01/2015;EGY
El Salvador;476203;42033;434170;2015;1;1;01/01/2015;SLV
Equatorial Guinea;297627;26270;271357;2015;1;1;01/01/2015;GNQ
Eritrea;29763;2627;27136;2015;1;1;01/01/2015;ERI
Estonia;1190507;105081;1085426;2015;1;1;01/01/2015;EST
Ethiopia;297627;26270;271357;2015;1;1;01/01/2015;ETH
Fiji;89288;7881;81407;2015;1;1;01/01/2015;FJI
Finland;15446830;1363430;14083400;2015;1;1;01/01/2015;FIN
France;166462664;14692996;151769668;2015;1;1;01/01/2015;FRA
Gabon;595254;52541;542713;2015;1;1;01/01/2015;GAB
Gambia;29763;2627;27136;2015;1;1;01/01/2015;GMB
Georgia;208339;18389;189950;2015;1;1;01/01/2015;GEO
Germany;212535291;18759643;193775648;2015;1;1;01/01/2015;DEU
Ghana;416677;36779;379898;2015;1;1;01/01/2015;GHA
Greece;18988589;1676047;17312542;2015;1;1;01/01/2015;GRC
Grenada;29763;2627;27136;2015;1;1;01/01/2015;GRD
Guatemala;803592;70930;732662;2015;1;1;01/01/2015;GTM
Guinea;29763;2627;27136;2015;1;1;01/01/2015;GIN
Guinea-Bissau;29763;2627;27136;2015;1;1;01/01/2015;GNB
Guyana;29763;2627;27136;2015;1;1;01/01/2015;GUY
Haiti;89288;7881;81407;2015;1;1;01/01/2015;HTI
Honduras;238101;21016;217085;2015;1;1;01/01/2015;HND
Hungary;7916873;698791;7218082;2015;1;1;01/01/2015;HUN
Iceland;803592;70930;732662;2015;1;1;01/01/2015;ISL
India;19821944;1749604;18072340;2015;1;1;01/01/2015;IND
Iran (Islamic Republic of);10595514;935224;9660290;2015;1;1;01/01/2015;IRN
Iraq;2023862;178638;1845224;2015;1;1;01/01/2015;IRQ
Ireland;12440800;1098100;11342700;2015;1;1;01/01/2015;IRL
Israel;11786021;1040305;10745716;2015;1;1;01/01/2015;ISR
Italy;132384396;11685043;120699353;2015;1;1;01/01/2015;ITA
Jamaica;327389;28897;298492;2015;1;1;01/01/2015;JAM
Japan;322419102;28458648;293960454;2015;1;1;01/01/2015;JPN
Jordan;654779;57795;596984;2015;1;1;01/01/2015;JOR
Kazakhstan;3601284;317871;3283413;2015;1;1;01/01/2015;KAZ
Kenya;386915;34152;352763;2015;1;1;01/01/2015;KEN
Kiribati;29763;2627;27136;2015;1;1;01/01/2015;KIR
Kuwait;8125211;717180;7408031;2015;1;1;01/01/2015;KWT
Kyrgyzstan;59525;5254;54271;2015;1;1;01/01/2015;KGZ
Lao People’s Democratic Republic;59525;5254;54271;2015;1;1;01/01/2015;LAO
Latvia;1398846;123471;1275375;2015;1;1;01/01/2015;LVA
Lebanon;1250032;110335;1139697;2015;1;1;01/01/2015;LBN
Lesotho;29763;2627;27136;2015;1;1;01/01/2015;LSO
Liberia;29763;2627;27136;2015;1;1;01/01/2015;LBR
Libya;4226300;373039;3853261;2015;1;1;01/01/2015;LBY
Liechtenstein;267864;23643;244221;2015;1;1;01/01/2015;LIE
Lithuania;2172675;191773;1980902;2015;1;1;01/01/2015;LTU
Luxembourg;2410777;212790;2197987;2015;1;1;01/01/2015;LUX
Madagascar;89288;7881;81407;2015;1;1;01/01/2015;MDG
Malawi;59525;5254;54271;2015;1;1;01/01/2015;MWI
Malaysia;8363313;738196;7625117;2015;1;1;01/01/2015;MYS
Maldives;29763;2627;27136;2015;1;1;01/01/2015;MDV
Mali;119051;10508;108543;2015;1;1;01/01/2015;MLI
Malta;476203;42033;434170;2015;1;1;01/01/2015;MLT
Marshall Islands;29763;2627;27136;2015;1;1;01/01/2015;MHL
Mauritania;59525;5254;54271;2015;1;1;01/01/2015;MRT
Mauritius;386915;34152;352763;2015;1;1;01/01/2015;MUS
Mexico;54822855;4838995;49983860;2015;1;1;01/01/2015;MEX
Micronesia (Federated States of);29763;2627;27136;2015;1;1;01/01/2015;FSM
Monaco;357152;31524;325628;2015;1;1;01/01/2015;MCO
Mongolia;89288;7881;81407;2015;1;1;01/01/2015;MNG
Montenegro;148813;13135;135678;2015;1;1;01/01/2015;MNE
Morocco;1845286;162876;1682410;2015;1;1;01/01/2015;MAR
Mozambique;89288;7881;81407;2015;1;1;01/01/2015;MOZ
Myanmar;297627;26270;271357;2015;1;1;01/01/2015;MMR
Namibia;297627;26270;271357;2015;1;1;01/01/2015;NAM
Nauru;29763;2627;27136;2015;1;1;01/01/2015;NRU
Nepal;178576;15762;162814;2015;1;1;01/01/2015;NPL
Netherlands;49227471;4345113;44882358;2015;1;1;01/01/2015;NLD
New Zealand;7529958;664639;6865319;2015;1;1;01/01/2015;NZL
Nicaragua;89288;7881;81407;2015;1;1;01/01/2015;NIC
Niger;59525;5254;54271;2015;1;1;01/01/2015;NER
Nigeria;2678641;236433;2442208;2015;1;1;01/01/2015;NGA
Norway;25328040;2235605;23092435;2015;1;1;01/01/2015;NOR
Oman;3035793;267957;2767836;2015;1;1;01/01/2015;OMN
Pakistan;2529828;223298;2306530;2015;1;1;01/01/2015;PAK
Palau;29763;2627;27136;2015;1;1;01/01/2015;PLW
Panama;773830;68303;705527;2015;1;1;01/01/2015;PAN
Papua New Guinea;119051;10508;108543;2015;1;1;01/01/2015;PNG
Paraguay;297627;26270;271357;2015;1;1;01/01/2015;PRY
Peru;3482233;307363;3174870;2015;1;1;01/01/2015;PER
Philippines;4583452;404563;4178889;2015;1;1;01/01/2015;PHL
Poland;27411427;2419497;24991930;2015;1;1;01/01/2015;POL
Portugal;14107510;1245214;12862296;2015;1;1;01/01/2015;PRT
Qatar;6220400;549050;5671350;2015;1;1;01/01/2015;QAT
Republic of Korea;59346782;5238304;54108478;2015;1;1;01/01/2015;KOR
Moldova;89288;7881;81407;2015;1;1;01/01/2015;MDA
Romania;6726365;593710;6132655;2015;1;1;01/01/2015;ROM
Russian Federation;72561411;6404707;66156704;2015;1;1;01/01/2015;RUS
Rwanda;59525;5254;54271;2015;1;1;01/01/2015;RWA
Saint Kitts and Nevis;29763;2627;27136;2015;1;1;01/01/2015;KN1
Saint Lucia;29763;2627;27136;2015;1;1;01/01/2015;LCA
Saint Vincent and the Grenadines;29763;2627;27136;2015;1;1;01/01/2015;VCT
Samoa;29763;2627;27136;2015;1;1;01/01/2015;WSM
San Marino;89288;7881;81407;2015;1;1;01/01/2015;SMR
Sao Tome and Principe;29763;2627;27136;2015;1;1;01/01/2015;STP
Saudi Arabia;25714955;2269757;23445198;2015;1;1;01/01/2015;SAU
Senegal;178576;15762;162814;2015;1;1;01/01/2015;SEN
Serbia;1190507;105081;1085426;2015;1;1;01/01/2015;SER
Seychelles;29763;2627;27136;2015;1;1;01/01/2015;SYC
Sierra Leone;29763;2627;27136;2015;1;1;01/01/2015;SLE
Singapore;11428869;1008781;10420088;2015;1;1;01/01/2015;SGP
Slovakia;5089418;449223;4640195;2015;1;1;01/01/2015;SVK
Slovenia;2976268;262703;2713565;2015;1;1;01/01/2015;SVN
Solomon Islands;29763;2627;27136;2015;1;1;01/01/2015;SLB
Somalia;29763;2627;27136;2015;1;1;01/01/2015;SOM
South Africa;11071717;977256;10094461;2015;1;1;01/01/2015;ZAF
South Sudan;119051;10508;108543;2015;1;1;01/01/2015;SSD
Spain;88484445;7810169;80674276;2015;1;1;01/01/2015;ESP
Sri Lanka;744067;65676;678391;2015;1;1;01/01/2015;LKA
Sudan;297627;26270;271357;2015;1;1;01/01/2015;SDN
Suriname;119051;10508;108543;2015;1;1;01/01/2015;SUR
Swaziland;89288;7881;81407;2015;1;1;01/01/2015;SWZ
Sweden;28572172;2521952;26050220;2015;1;1;01/01/2015;SWE
Switzerland;31161525;2750504;28411021;2015;1;1;01/01/2015;CHE
Syrian Arab Republic;1071456;94573;976883;2015;1;1;01/01/2015;SYR
Tajikistan;89288;7881;81407;2015;1;1;01/01/2015;TJK
Thailand;7113280;627861;6485419;2015;1;1;01/01/2015;THA
North Macedonia;238101;21016;217085;2015;1;1;01/01/2015;MKD
Timor-Leste;59525;5254;54271;2015;1;1;01/01/2015;TMP
Togo;29763;2627;27136;2015;1;1;01/01/2015;TGO
Tonga;29763;2627;27136;2015;1;1;01/01/2015;TON
Trinidad and Tobago;1309558;115590;1193968;2015;1;1;01/01/2015;TTO
Tunisia;1071456;94573;976883;2015;1;1;01/01/2015;TUN
Turkey;39524838;3488700;36036138;2015;1;1;01/01/2015;TUR
Turkmenistan;565491;49914;515577;2015;1;1;01/01/2015;TKM
Tuvalu;29763;2627;27136;2015;1;1;01/01/2015;TUV
Uganda;178576;15762;162814;2015;1;1;01/01/2015;UGA
Ukraine;2946505;260076;2686429;2015;1;1;01/01/2015;UKR
United Arab Emirates;17708794;1563085;16145709;2015;1;1;01/01/2015;ARE
United Kingdom of Great Britain and  Northern Ireland;154140914;13605404;140535510;2015;1;1;01/01/2015;GBR
United Republic of Tanzania;267864;23643;244221;2015;1;1;01/01/2015;TZA
United States of America;654778938;–a;654778938;2015;1;1;01/01/2015;USA
Uruguay;1547659;136606;1411053;2015;1;1;01/01/2015;URY
Uzbekistan;446440;39406;407034;2015;1;1;01/01/2015;UZB
Vanuatu;29763;2627;27136;2015;1;1;01/01/2015;VUT
Venezuela;18661200;1647150;17014050;2015;1;1;01/01/2015;VEN
Viet Nam;1250032;110335;1139697;2015;1;1;01/01/2015;VNM
Yemen;297627;26270;271357;2015;1;1;01/01/2015;YEM
Zambia;178576;15762;162814;2015;1;1;01/01/2015;ZMB
Zimbabwe;59525;5254;54271;2015;1;1;01/01/2015;ZWE
Indonesia;10297887;908953;9388934;2015;1;1;01/01/2015;IDN
Afghanistan;141183;13585;127598;2014;1;1;01/01/2014;AFG
Albania;282365;27169;255196;2014;1;1;01/01/2014;ALB
Algeria;3868405;372218;3496187;2014;1;1;01/01/2014;DZA
Andorra;225892;21735;204157;2014;1;1;01/01/2014;AND
Angola;282365;27169;255196;2014;1;1;01/01/2014;AGO
Antigua and Barbuda;56473;5434;51039;2014;1;1;01/01/2014;ATG
Argentina;12198181;1173711;11024470;2014;1;1;01/01/2014;ARG
Armenia;197656;19018;178638;2014;1;1;01/01/2014;ARM
Australia;58562565;5634898;52927667;2014;1;1;01/01/2014;AUS
Austria;22532752;2168105;20364647;2014;1;1;01/01/2014;AUT
Azerbaijan;1129461;108677;1020784;2014;1;1;01/01/2014;AZE
Bahamas;480021;46188;433833;2014;1;1;01/01/2014;BHS
Bahrain;1101225;105960;995265;2014;1;1;01/01/2014;BHR
Bangladesh;282365;27169;255196;2014;1;1;01/01/2014;BGD
Barbados;225892;21735;204157;2014;1;1;01/01/2014;BRB
Belarus;1581246;152148;1429098;2014;1;1;01/01/2014;BLR
Belgium;28180058;2711489;25468569;2014;1;1;01/01/2014;BEL
Belize;28237;2717;25520;2014;1;1;01/01/2014;BLZ
Benin;84709;8151;76558;2014;1;1;01/01/2014;BEN
Bhutan;28237;2717;25520;2014;1;1;01/01/2014;BTN
Bolivia;254129;24452;229677;2014;1;1;01/01/2014;BOL
Bosnia and Herzegovina;480021;46188;433833;2014;1;1;01/01/2014;BIH
Botswana;480021;46188;433833;2014;1;1;01/01/2014;BWA
Brazil;82845982;7971452;74874530;2014;1;1;01/01/2014;BRA
Brunei Darussalam;734150;70640;663510;2014;1;1;01/01/2014;BRN
Bulgaria;1327117;127695;1199422;2014;1;1;01/01/2014;BGR
Burkina Faso;84709;8151;76558;2014;1;1;01/01/2014;BFA
Burundi;28237;2717;25520;2014;1;1;01/01/2014;BDI
Cape Verde;28237;2717;25520;2014;1;1;01/01/2014;CPV
Cambodia;112946;10868;102078;2014;1;1;01/01/2014;KHM
Cameroon;338838;32603;306235;2014;1;1;01/01/2014;CMR
Canada;84257808;8107298;76150510;2014;1;1;01/01/2014;CAN
Central African Republic;28237;2717;25520;2014;1;1;01/01/2014;CAF
Chad;56473;5434;51039;2014;1;1;01/01/2014;TCD
Chile;9431001;907452;8523549;2014;1;1;01/01/2014;CHL
China;145361662;13986720;131374942;2014;1;1;01/01/2014;CHN
Colombia;7313261;703683;6609578;2014;1;1;01/01/2014;COL
Comoros;28237;2717;25520;2014;1;1;01/01/2014;COM
Congo;141183;13585;127598;2014;1;1;01/01/2014;COG
Costa Rica;1072988;103243;969745;2014;1;1;01/01/2014;CRI
Côte d’Ivoire;310602;29886;280716;2014;1;1;01/01/2014;CIV
Croatia;3557803;342332;3215471;2014;1;1;01/01/2014;HRV
Cuba;1948321;187468;1760853;2014;1;1;01/01/2014;CUB
Cyprus;1327117;127695;1199422;2014;1;1;01/01/2014;CYP
Czech Republic;10899301;1048732;9850569;2014;1;1;01/01/2014;CZE
Democratic People’s Republic of Korea;169419;16302;153117;2014;1;1;01/01/2014;PRK
Democratic Republic of the Congo;84709;8151;76558;2014;1;1;01/01/2014;ZAR
Denmark;19059658;1833923;17225735;2014;1;1;01/01/2014;DNK
Djibouti;28237;2717;25520;2014;1;1;01/01/2014;DJI
Dominica;28237;2717;25520;2014;1;1;01/01/2014;DMA
Dominican Republic;1270644;122261;1148383;2014;1;1;01/01/2014;DOM
Ecuador;1242407;119545;1122862;2014;1;1;01/01/2014;ECU
Egypt;3783695;364068;3419627;2014;1;1;01/01/2014;EGY
El Salvador;451784;43471;408313;2014;1;1;01/01/2014;SLV
Equatorial Guinea;282365;27169;255196;2014;1;1;01/01/2014;GNQ
Eritrea;28237;2717;25520;2014;1;1;01/01/2014;ERI
Estonia;1129461;108677;1020784;2014;1;1;01/01/2014;EST
Ethiopia;282365;27169;255196;2014;1;1;01/01/2014;ETH
Fiji;84709;8151;76558;2014;1;1;01/01/2014;FJI
Finland;14654760;1410083;13244677;2014;1;1;01/01/2014;FIN
France;157926918;15195750;142731168;2014;1;1;01/01/2014;FRA
Gabon;564731;54338;510393;2014;1;1;01/01/2014;GAB
Gambia;28237;2717;25520;2014;1;1;01/01/2014;GMB
Georgia;197656;19018;178638;2014;1;1;01/01/2014;GEO
Germany;201637068;19401547;182235521;2014;1;1;01/01/2014;DEU
Ghana;395311;38037;357274;2014;1;1;01/01/2014;GHA
Greece;18014907;1733397;16281510;2014;1;1;01/01/2014;GRC
Grenada;28237;2717;25520;2014;1;1;01/01/2014;GRD
Guatemala;762386;73357;689029;2014;1;1;01/01/2014;GTM
Guinea;28237;2717;25520;2014;1;1;01/01/2014;GIN
Guinea-Bissau;28237;2717;25520;2014;1;1;01/01/2014;GNB
Guyana;28237;2717;25520;2014;1;1;01/01/2014;GUY
Haiti;84709;8151;76558;2014;1;1;01/01/2014;HTI
Honduras;225892;21735;204157;2014;1;1;01/01/2014;HND
Hungary;7510917;722701;6788216;2014;1;1;01/01/2014;HUN
Iceland;762386;73357;689029;2014;1;1;01/01/2014;ISL
India;18805530;1809471;16996059;2014;1;1;01/01/2014;IND
Iran (Islamic Republic of);10052205;967225;9084980;2014;1;1;01/01/2014;IRN
Iraq;1920084;184751;1735333;2014;1;1;01/01/2014;IRQ
Ireland;11802870;1135674;10667196;2014;1;1;01/01/2014;IRL
Israel;11181666;1075901;10105765;2014;1;1;01/01/2014;ISR
Italy;125596090;12084873;113511217;2014;1;1;01/01/2014;ITA
Jamaica;310602;29886;280716;2014;1;1;01/01/2014;JAM
Japan;305886340;29432427;276453913;2014;1;1;01/01/2014;JPN
Jordan;621204;59772;561432;2014;1;1;01/01/2014;JOR
Kazakhstan;3416620;328748;3087872;2014;1;1;01/01/2014;KAZ
Kenya;367075;35320;331755;2014;1;1;01/01/2014;KEN
Kiribati;28237;2717;25520;2014;1;1;01/01/2014;KIR
Kuwait;7708573;741720;6966853;2014;1;1;01/01/2014;KWT
Kyrgyzstan;56473;5434;51039;2014;1;1;01/01/2014;KGZ
Lao People’s Democratic Republic;56473;5434;51039;2014;1;1;01/01/2014;LAO
Latvia;1327117;127695;1199422;2014;1;1;01/01/2014;LVA
Lebanon;1185934;114111;1071823;2014;1;1;01/01/2014;LBN
Lesotho;28237;2717;25520;2014;1;1;01/01/2014;LSO
Liberia;28237;2717;25520;2014;1;1;01/01/2014;LBR
Libya;4009587;385803;3623784;2014;1;1;01/01/2014;LBY
Liechtenstein;254129;24452;229677;2014;1;1;01/01/2014;LIE
Lithuania;2061267;198335;1862932;2014;1;1;01/01/2014;LTU
Luxembourg;2287159;220071;2067088;2014;1;1;01/01/2014;LUX
Madagascar;84709;8151;76558;2014;1;1;01/01/2014;MDG
Malawi;56473;5434;51039;2014;1;1;01/01/2014;MWI
Malaysia;7934465;763455;7171010;2014;1;1;01/01/2014;MYS
Maldives;28237;2717;25520;2014;1;1;01/01/2014;MDV
Mali;112946;10868;102078;2014;1;1;01/01/2014;MLI
Malta;451784;43471;408313;2014;1;1;01/01/2014;MLT
Marshall Islands;28237;2717;25520;2014;1;1;01/01/2014;MHL
Mauritania;56473;5434;51039;2014;1;1;01/01/2014;MRT
Mauritius;367075;35320;331755;2014;1;1;01/01/2014;MUS
Mexico;52011690;5004572;47007118;2014;1;1;01/01/2014;MEX
Micronesia (Federated States of);28237;2717;25520;2014;1;1;01/01/2014;FSM
Monaco;338838;32603;306235;2014;1;1;01/01/2014;MCO
Mongolia;84709;8151;76558;2014;1;1;01/01/2014;MNG
Montenegro;141183;13585;127598;2014;1;1;01/01/2014;MNE
Morocco;1750665;168449;1582216;2014;1;1;01/01/2014;MAR
Mozambique;84709;8151;76558;2014;1;1;01/01/2014;MOZ
Myanmar;282365;27169;255196;2014;1;1;01/01/2014;MMR
Namibia;282365;27169;255196;2014;1;1;01/01/2014;NAM
Nauru;28237;2717;25520;2014;1;1;01/01/2014;NRU
Nepal;169419;16302;153117;2014;1;1;01/01/2014;NPL
Netherlands;46703222;4493791;42209431;2014;1;1;01/01/2014;NLD
New Zealand;7143842;687381;6456461;2014;1;1;01/01/2014;NZL
Nicaragua;84709;8151;76558;2014;1;1;01/01/2014;NIC
Niger;56473;5434;51039;2014;1;1;01/01/2014;NER
Nigeria;2541288;244523;2296765;2014;1;1;01/01/2014;NGA
Norway;24029288;2312101;21717187;2014;1;1;01/01/2014;NOR
Oman;2880126;277126;2603000;2014;1;1;01/01/2014;OMN
Pakistan;2400105;230938;2169167;2014;1;1;01/01/2014;PAK
Palau;28237;2717;25520;2014;1;1;01/01/2014;PLW
Panama;734150;70640;663510;2014;1;1;01/01/2014;PAN
Papua New Guinea;112946;10868;102078;2014;1;1;01/01/2014;PNG
Paraguay;282365;27169;255196;2014;1;1;01/01/2014;PRY
Peru;3303674;317880;2985794;2014;1;1;01/01/2014;PER
Philippines;4348426;418406;3930020;2014;1;1;01/01/2014;PHL
Poland;26005845;2502286;23503559;2014;1;1;01/01/2014;POL
Portugal;13384116;1287821;12096295;2014;1;1;01/01/2014;PRT
Qatar;5901435;567837;5333598;2014;1;1;01/01/2014;QAT
Republic of Korea;56303643;5417544;50886099;2014;1;1;01/01/2014;KOR
Moldova;84709;8151;76558;2014;1;1;01/01/2014;MDA
Romania;6381456;614025;5767431;2014;1;1;01/01/2014;ROM
Russian Federation;68840662;6623858;62216804;2014;1;1;01/01/2014;RUS
Rwanda;56473;5434;51039;2014;1;1;01/01/2014;RWA
Saint Kitts and Nevis;28237;2717;25520;2014;1;1;01/01/2014;KN1
Saint Lucia;28237;2717;25520;2014;1;1;01/01/2014;LCA
Saint Vincent and the Grenadines;28237;2717;25520;2014;1;1;01/01/2014;VCT
Samoa;28237;2717;25520;2014;1;1;01/01/2014;WSM
San Marino;84709;8151;76558;2014;1;1;01/01/2014;SMR
Sao Tome and Principe;28237;2717;25520;2014;1;1;01/01/2014;STP
Saudi Arabia;24396363;2347421;22048942;2014;1;1;01/01/2014;SAU
Senegal;169419;16302;153117;2014;1;1;01/01/2014;SEN
Serbia;1129461;108677;1020784;2014;1;1;01/01/2014;SER
Seychelles;28237;2717;25520;2014;1;1;01/01/2014;SYC
Sierra Leone;28237;2717;25520;2014;1;1;01/01/2014;SLE
Singapore;10842828;1043298;9799530;2014;1;1;01/01/2014;SGP
Slovakia;4828447;464594;4363853;2014;1;1;01/01/2014;SVK
Slovenia;2823653;271692;2551961;2014;1;1;01/01/2014;SVN
Solomon Islands;28237;2717;25520;2014;1;1;01/01/2014;SLB
Somalia;28237;2717;25520;2014;1;1;01/01/2014;SOM
South Africa;10503989;1010695;9493294;2014;1;1;01/01/2014;ZAF
South Sudan;112946;10868;102078;2014;1;1;01/01/2014;SSD
Spain;83947207;8077412;75869795;2014;1;1;01/01/2014;ESP
Sri Lanka;705913;67923;637990;2014;1;1;01/01/2014;LKA
Sudan;282365;27169;255196;2014;1;1;01/01/2014;SDN
Suriname;112946;10868;102078;2014;1;1;01/01/2014;SUR
Swaziland;84709;8151;76558;2014;1;1;01/01/2014;SWZ
Sweden;27107070;2608246;24498824;2014;1;1;01/01/2014;SWE
Switzerland;29563648;2844618;26719030;2014;1;1;01/01/2014;CHE
Syrian Arab Republic;1016515;97809;918706;2014;1;1;01/01/2014;SYR
Tajikistan;84709;8151;76558;2014;1;1;01/01/2014;TJK
Thailand;6748531;649345;6099186;2014;1;1;01/01/2014;THA
North Macedonia;225892;21735;204157;2014;1;1;01/01/2014;MKD
Timor-Leste;56473;5434;51039;2014;1;1;01/01/2014;TMP
Togo;28237;2717;25520;2014;1;1;01/01/2014;TGO
Tonga;28237;2717;25520;2014;1;1;01/01/2014;TON
Trinidad and Tobago;1242407;119545;1122862;2014;1;1;01/01/2014;TTO
Tunisia;1016515;97809;918706;2014;1;1;01/01/2014;TUN
Turkey;37498113;3608074;33890039;2014;1;1;01/01/2014;TUR
Turkmenistan;536494;51621;484873;2014;1;1;01/01/2014;TKM
Tuvalu;28237;2717;25520;2014;1;1;01/01/2014;TUV
Uganda;169419;16302;153117;2014;1;1;01/01/2014;UGA
Ukraine;2795416;268975;2526441;2014;1;1;01/01/2014;UKR
United Arab Emirates;16800736;1616569;15184167;2014;1;1;01/01/2014;ARE
United Kingdom of Great Britain and  Northern Ireland;146236994;14070944;132166050;2014;1;1;01/01/2014;GBR
United Republic of Tanzania;254129;24452;229677;2014;1;1;01/01/2014;TZA
United States of America;621203682;–a;621203682;2014;1;1;01/01/2014;USA
Uruguay;1468300;141280;1327020;2014;1;1;01/01/2014;URY
Uzbekistan;423548;40754;382794;2014;1;1;01/01/2014;UZB
Vanuatu;28237;2717;25520;2014;1;1;01/01/2014;VUT
Venezuela;17704305;1703511;16000794;2014;1;1;01/01/2014;VEN
Viet Nam;1185934;114111;1071823;2014;1;1;01/01/2014;VNM
Yemen;282365;27169;255196;2014;1;1;01/01/2014;YEM
Zambia;169419;16302;153117;2014;1;1;01/01/2014;ZMB
Zimbabwe;56473;5434;51039;2014;1;1;01/01/2014;ZWE
Indonesia;9769840;940055;8829785;2014;1;1;01/01/2014;IDN
Afghanistan;140564;13150;127414;2013;1;1;01/01/2013;AFG
Albania;281128;26300;254828;2013;1;1;01/01/2013;ALB
Algeria;3851451;360305;3491146;2013;1;1;01/01/2013;DZA
Andorra;224902;21040;203862;2013;1;1;01/01/2013;AND
Angola;281128;26300;254828;2013;1;1;01/01/2013;AGO
Antigua and Barbuda;56226;5260;50966;2013;1;1;01/01/2013;ATG
Argentina;12144721;1136143;11008578;2013;1;1;01/01/2013;ARG
Armenia;196789;18410;178379;2013;1;1;01/01/2013;ARM
Australia;58305908;5454539;52851369;2013;1;1;01/01/2013;AUS
Austria;22433999;2098709;20335290;2013;1;1;01/01/2013;AUT
Azerbaijan;1124511;105198;1019313;2013;1;1;01/01/2013;AZE
Bahamas;477917;44709;433208;2013;1;1;01/01/2013;BHS
Bahrain;1096398;102568;993830;2013;1;1;01/01/2013;BHR
Bangladesh;281128;26300;254828;2013;1;1;01/01/2013;BGD
Barbados;224902;21040;203862;2013;1;1;01/01/2013;BRB
Belarus;1574316;147278;1427038;2013;1;1;01/01/2013;BLR
Belgium;28056555;2624701;25431854;2013;1;1;01/01/2013;BEL
Belize;28113;2630;25483;2013;1;1;01/01/2013;BLZ
Benin;84338;7890;76448;2013;1;1;01/01/2013;BEN
Bhutan;28113;2630;25483;2013;1;1;01/01/2013;BTN
Bolivia;253015;23670;229345;2013;1;1;01/01/2013;BOL
Bosnia and Herzegovina;477917;44709;433208;2013;1;1;01/01/2013;BIH
Botswana;477917;44709;433208;2013;1;1;01/01/2013;BWA
Brazil;82482899;7716306;74766593;2013;1;1;01/01/2013;BRA
Brunei Darussalam;730932;68379;662553;2013;1;1;01/01/2013;BRN
Bulgaria;1321301;123608;1197693;2013;1;1;01/01/2013;BGR
Burkina Faso;84338;7890;76448;2013;1;1;01/01/2013;BFA
Burundi;28113;2630;25483;2013;1;1;01/01/2013;BDI
Cambodia;112451;10520;101931;2013;1;1;01/01/2013;KHM
Cameroon;337353;31559;305794;2013;1;1;01/01/2013;CMR
Canada;83888538;7847804;76040734;2013;1;1;01/01/2013;CAN
Cape Verde;28113;2630;25483;2013;1;1;01/01/2013;CPV
Central African Republic;28113;2630;25483;2013;1;1;01/01/2013;CAF
Chad;56226;5260;50966;2013;1;1;01/01/2013;TCD
Chile;9389669;878407;8511262;2013;1;1;01/01/2013;CHL
China;144724597;13539039;131185558;2013;1;1;01/01/2013;CHN
Colombia;7281210;681160;6600050;2013;1;1;01/01/2013;COL
Comoros;28113;2630;25483;2013;1;1;01/01/2013;COM
Congo;140564;13150;127414;2013;1;1;01/01/2013;COG
Costa Rica;1068286;99938;968348;2013;1;1;01/01/2013;CRI
Côte d’Ivoire;309241;28930;280311;2013;1;1;01/01/2013;CIV
Croatia;3542210;331375;3210835;2013;1;1;01/01/2013;HRV
Cuba;1939782;181467;1758315;2013;1;1;01/01/2013;CUB
Cyprus;1321301;123608;1197693;2013;1;1;01/01/2013;CYP
Czech Republic;10851533;1015165;9836368;2013;1;1;01/01/2013;CZE
Democratic People’s Republic of Korea;168677;15780;152897;2013;1;1;01/01/2013;PRK
Democratic Republic of the Congo;84338;7890;76448;2013;1;1;01/01/2013;ZAR
Denmark;18976127;1775224;17200903;2013;1;1;01/01/2013;DNK
Djibouti;28113;2630;25483;2013;1;1;01/01/2013;DJI
Dominica;28113;2630;25483;2013;1;1;01/01/2013;DMA
Dominican Republic;1265075;118348;1146727;2013;1;1;01/01/2013;DOM
Ecuador;1236962;115718;1121244;2013;1;1;01/01/2013;ECU
Egypt;3767113;352415;3414698;2013;1;1;01/01/2013;EGY
El Salvador;449804;42079;407725;2013;1;1;01/01/2013;SLV
Equatorial Guinea;281128;26300;254828;2013;1;1;01/01/2013;GNQ
Eritrea;28113;2630;25483;2013;1;1;01/01/2013;ERI
Estonia;1124511;105198;1019313;2013;1;1;01/01/2013;EST
Ethiopia;281128;26300;254828;2013;1;1;01/01/2013;ETH
Fiji;84338;7890;76448;2013;1;1;01/01/2013;FJI
Finland;14590533;1364950;13225583;2013;1;1;01/01/2013;FIN
France;157234784;14709372;142525412;2013;1;1;01/01/2013;FRA
Gabon;562256;52599;509657;2013;1;1;01/01/2013;GAB
Gambia;28113;2630;25483;2013;1;1;01/01/2013;GMB
Georgia;196789;18410;178379;2013;1;1;01/01/2013;GEO
Germany;200753369;18780551;181972818;2013;1;1;01/01/2013;DEU
Ghana;393579;36819;356760;2013;1;1;01/01/2013;GHA
Greece;17935954;1677915;16258039;2013;1;1;01/01/2013;GRC
Grenada;28113;2630;25483;2013;1;1;01/01/2013;GRD
Guatemala;759045;71009;688036;2013;1;1;01/01/2013;GTM
Guinea;28113;2630;25483;2013;1;1;01/01/2013;GIN
Guinea-Bissau;28113;2630;25483;2013;1;1;01/01/2013;GNB
Guyana;28113;2630;25483;2013;1;1;01/01/2013;GUY
Haiti;84338;7890;76448;2013;1;1;01/01/2013;HTI
Honduras;224902;21040;203862;2013;1;1;01/01/2013;HND
Hungary;7478000;699570;6778430;2013;1;1;01/01/2013;HUN
Iceland;759045;71009;688036;2013;1;1;01/01/2013;ISL
India;18723112;1751554;16971558;2013;1;1;01/01/2013;IND
Iran (Islamic Republic of);10008150;936266;9071884;2013;1;1;01/01/2013;IRN
Iraq;1911669;178837;1732832;2013;1;1;01/01/2013;IRQ
Ireland;11751142;1099324;10651818;2013;1;1;01/01/2013;IRL
Israel;11132661;1041464;10091197;2013;1;1;01/01/2013;ISR
Italy;125045650;11698066;113347584;2013;1;1;01/01/2013;ITA
Jamaica;309241;28930;280311;2013;1;1;01/01/2013;JAM
Japan;304545757;28490368;276055389;2013;1;1;01/01/2013;JPN
Jordan;618481;57859;560622;2013;1;1;01/01/2013;JOR
Kazakhstan;3401646;318225;3083421;2013;1;1;01/01/2013;KAZ
Kenya;365466;34189;331277;2013;1;1;01/01/2013;KEN
Kiribati;28113;2630;25483;2013;1;1;01/01/2013;KIR
Kuwait;7674789;717979;6956810;2013;1;1;01/01/2013;KWT
Kyrgyzstan;56226;5260;50966;2013;1;1;01/01/2013;KGZ
Lao People’s Democratic Republic;56226;5260;50966;2013;1;1;01/01/2013;LAO
Latvia;1321301;123608;1197693;2013;1;1;01/01/2013;LVA
Lebanon;1180737;110458;1070279;2013;1;1;01/01/2013;LBN
Lesotho;28113;2630;25483;2013;1;1;01/01/2013;LSO
Liberia;28113;2630;25483;2013;1;1;01/01/2013;LBR
Libya;3992015;373454;3618561;2013;1;1;01/01/2013;LBY
Liechtenstein;253015;23670;229345;2013;1;1;01/01/2013;LIE
Lithuania;2052233;191987;1860246;2013;1;1;01/01/2013;LTU
Luxembourg;2277135;213027;2064108;2013;1;1;01/01/2013;LUX
Madagascar;84338;7890;76448;2013;1;1;01/01/2013;MDG
Malawi;56226;5260;50966;2013;1;1;01/01/2013;MWI
Malaysia;7899691;739019;7160672;2013;1;1;01/01/2013;MYS
Maldives;28113;2630;25483;2013;1;1;01/01/2013;MDV
Mali;112451;10520;101931;2013;1;1;01/01/2013;MLI
Malta;449804;42079;407725;2013;1;1;01/01/2013;MLT
Marshall Islands;28113;2630;25483;2013;1;1;01/01/2013;MHL
Mauritania;56226;5260;50966;2013;1;1;01/01/2013;MRT
Mauritius;365466;34189;331277;2013;1;1;01/01/2013;MUS
Mexico;51783743;4844388;46939355;2013;1;1;01/01/2013;MEX
Micronesia (Federated States of);28113;2630;25483;2013;1;1;01/01/2013;FSM
Monaco;337353;31559;305794;2013;1;1;01/01/2013;MCO
Mongolia;84338;7890;76448;2013;1;1;01/01/2013;MNG
Montenegro;140564;13150;127414;2013;1;1;01/01/2013;MNE
Morocco;1742992;163058;1579934;2013;1;1;01/01/2013;MAR
Mozambique;84338;7890;76448;2013;1;1;01/01/2013;MOZ
Myanmar;281128;26300;254828;2013;1;1;01/01/2013;MMR
Namibia;281128;26300;254828;2013;1;1;01/01/2013;NAM
Nauru;28113;2630;25483;2013;1;1;01/01/2013;NRU
Nepal;168677;15780;152897;2013;1;1;01/01/2013;NPL
Netherlands;46498540;4349955;42148585;2013;1;1;01/01/2013;NLD
New Zealand;7112534;665380;6447154;2013;1;1;01/01/2013;NZL
Nicaragua;84338;7890;76448;2013;1;1;01/01/2013;NIC
Niger;56226;5260;50966;2013;1;1;01/01/2013;NER
Nigeria;2530150;236696;2293454;2013;1;1;01/01/2013;NGA
Norway;23923977;2238097;21685880;2013;1;1;01/01/2013;NOR
Oman;2867504;268256;2599248;2013;1;1;01/01/2013;OMN
Pakistan;2389586;223547;2166039;2013;1;1;01/01/2013;PAK
Palau;28113;2630;25483;2013;1;1;01/01/2013;PLW
Panama;730932;68379;662553;2013;1;1;01/01/2013;PAN
Papua New Guinea;112451;10520;101931;2013;1;1;01/01/2013;PNG
Paraguay;281128;26300;254828;2013;1;1;01/01/2013;PRY
Peru;3289195;307705;2981490;2013;1;1;01/01/2013;PER
Philippines;4329368;405014;3924354;2013;1;1;01/01/2013;PHL
Poland;25891871;2422194;23469677;2013;1;1;01/01/2013;POL
Portugal;13325458;1246601;12078857;2013;1;1;01/01/2013;PRT
Qatar;5875571;549662;5325909;2013;1;1;01/01/2013;QAT
Republic of Korea;56056885;5244142;50812743;2013;1;1;01/01/2013;KOR
Moldova;84338;7890;76448;2013;1;1;01/01/2013;MDA
Romania;6353488;594371;5759117;2013;1;1;01/01/2013;ROM
Russian Federation;68538960;6411845;62127115;2013;1;1;01/01/2013;RUS
Rwanda;56226;5260;50966;2013;1;1;01/01/2013;RWA
Saint Kitts and Nevis;28113;2630;25483;2013;1;1;01/01/2013;KN1
Saint Lucia;28113;2630;25483;2013;1;1;01/01/2013;LCA
Saint Vincent and the Grenadines;28113;2630;25483;2013;1;1;01/01/2013;VCT
Samoa;28113;2630;25483;2013;1;1;01/01/2013;WSM
San Marino;84338;7890;76448;2013;1;1;01/01/2013;SMR
Sao Tome and Principe;28113;2630;25483;2013;1;1;01/01/2013;STP
Saudi Arabia;24289443;2272286;22017157;2013;1;1;01/01/2013;SAU
Senegal;168677;15780;152897;2013;1;1;01/01/2013;SEN
Serbia;1124511;105198;1019313;2013;1;1;01/01/2013;SER
Seychelles;28113;2630;25483;2013;1;1;01/01/2013;SYC
Sierra Leone;28113;2630;25483;2013;1;1;01/01/2013;SLE
Singapore;10795308;1009905;9785403;2013;1;1;01/01/2013;SGP
Slovakia;4807285;449723;4357562;2013;1;1;01/01/2013;SVK
Slovenia;2811278;262996;2548282;2013;1;1;01/01/2013;SVN
Solomon Islands;28113;2630;25483;2013;1;1;01/01/2013;SLB
Somalia;28113;2630;25483;2013;1;1;01/01/2013;SOM
South Africa;10457954;978345;9479609;2013;1;1;01/01/2013;ZAF
South Sudan;112451;10520;101931;2013;1;1;01/01/2013;SSD
Spain;83579298;7818874;75760424;2013;1;1;01/01/2013;ESP
Sri Lanka;702819;65749;637070;2013;1;1;01/01/2013;LKA
Sudan;281128;26300;254828;2013;1;1;01/01/2013;SDN
Suriname;112451;10520;101931;2013;1;1;01/01/2013;SUR
Swaziland;84338;7890;76448;2013;1;1;01/01/2013;SWZ
Sweden;26988270;2524762;24463508;2013;1;1;01/01/2013;SWE
Switzerland;29434082;2753569;26680513;2013;1;1;01/01/2013;CHE
Syrian Arab Republic;1012060;94679;917381;2013;1;1;01/01/2013;SYR
Tajikistan;84338;7890;76448;2013;1;1;01/01/2013;TJK
Thailand;6718955;628561;6090394;2013;1;1;01/01/2013;THA
North Macedonia;224902;21040;203862;2013;1;1;01/01/2013;MKD
Timor-Leste;56226;5260;50966;2013;1;1;01/01/2013;TMP
Togo;28113;2630;25483;2013;1;1;01/01/2013;TGO
Tonga;28113;2630;25483;2013;1;1;01/01/2013;TON
Trinidad and Tobago;1236962;115718;1121244;2013;1;1;01/01/2013;TTO
Tunisia;1012060;94679;917381;2013;1;1;01/01/2013;TUN
Turkey;37333773;3492588;33841185;2013;1;1;01/01/2013;TUR
Turkmenistan;534143;49969;484174;2013;1;1;01/01/2013;TKM
Tuvalu;28113;2630;25483;2013;1;1;01/01/2013;TUV
Uganda;168677;15780;152897;2013;1;1;01/01/2013;UGA
Ukraine;2783165;260366;2522799;2013;1;1;01/01/2013;UKR
United Arab Emirates;16727105;1564827;15162278;2013;1;1;01/01/2013;ARE
United Kingdom of Great Britain and  Northern Ireland;145596093;13620568;131975525;2013;1;1;01/01/2013;GBR
United Republic of Tanzania;253015;23670;229345;2013;1;1;01/01/2013;TZA
United States of America;618481182;a;618481182;2013;1;1;01/01/2013;USA
Uruguay;1461865;136758;1325107;2013;1;1;01/01/2013;URY
Uzbekistan;421692;39449;382243;2013;1;1;01/01/2013;UZB
Vanuatu;28113;2630;25483;2013;1;1;01/01/2013;VUT
Venezuela;17626714;1648985;15977729;2013;1;1;01/01/2013;VEN
Viet Nam;1180737;110458;1070279;2013;1;1;01/01/2013;VNM
Yemen;281128;26300;254828;2013;1;1;01/01/2013;YEM
Zambia;168677;15780;152897;2013;1;1;01/01/2013;ZMB
Zimbabwe;56226;5260;50966;2013;1;1;01/01/2013;ZWE
Indonesia;9727022;909966;8817056;2013;1;1;01/01/2013;IDN
Afghanistan;103409;8883;94526;2012;1;1;01/01/2012;AFG
Albania;258523;22206;236317;2012;1;1;01/01/2012;ALB
Algeria;3309096;284244;3024852;2012;1;1;01/01/2012;DZA
Andorra;180966;15545;165421;2012;1;1;01/01/2012;AND
Angola;258523;22206;236317;2012;1;1;01/01/2012;AGO
Antigua and Barbuda;51705;4441;47264;2012;1;1;01/01/2012;ATG
Argentina;7419612;637328;6782284;2012;1;1;01/01/2012;ARG
Armenia;129262;11103;118159;2012;1;1;01/01/2012;ARM
Australia;49972511;4292528;45679983;2012;1;1;01/01/2012;AUS
Austria;22000314;1889778;20110536;2012;1;1;01/01/2012;AUT
Azerbaijan;387785;33310;354475;2012;1;1;01/01/2012;AZE
Bahamas;465342;39972;425370;2012;1;1;01/01/2012;BHS
Bahrain;1008240;86605;921635;2012;1;1;01/01/2012;BHR
Bangladesh;258523;22206;236317;2012;1;1;01/01/2012;BGD
Barbados;206819;17765;189054;2012;1;1;01/01/2012;BRB
Belarus;1085797;93267;992530;2012;1;1;01/01/2012;BLR
Belgium;27791231;2387205;25404026;2012;1;1;01/01/2012;BEL
Belize;25852;2221;23631;2012;1;1;01/01/2012;BLZ
Benin;77557;6662;70895;2012;1;1;01/01/2012;BEN
Bhutan;25852;2221;23631;2012;1;1;01/01/2012;BTN
Bolivia;180966;15545;165421;2012;1;1;01/01/2012;BOL
Bosnia and Herzegovina;361932;31089;330843;2012;1;1;01/01/2012;BIH
Botswana;465342;39972;425370;2012;1;1;01/01/2012;BWA
Brazil;41648068;3577477;38070591;2012;1;1;01/01/2012;BRA
Brunei Darussalam;723865;62178;661687;2012;1;1;01/01/2012;BRN
Bulgaria;982388;84385;898003;2012;1;1;01/01/2012;BGR
Burkina Faso;77557;6662;70895;2012;1;1;01/01/2012;BFA
Burundi;25852;2221;23631;2012;1;1;01/01/2012;BDI
Cambodia;77557;6662;70895;2012;1;1;01/01/2012;KHM
Cameroon;284375;24427;259948;2012;1;1;01/01/2012;CMR
Canada;82908352;7121644;75786708;2012;1;1;01/01/2012;CAN
Cape Verde;25852;2221;23631;2012;1;1;01/01/2012;CPV
Central African Republic;25852;2221;23631;2012;1;1;01/01/2012;CAF
Chad;51705;4441;47264;2012;1;1;01/01/2012;TCD
Chile;6101145;524075;5577070;2012;1;1;01/01/2012;CHL
China;82443010;7081672;75361338;2012;1;1;01/01/2012;CHN
Colombia;3722732;319774;3402958;2012;1;1;01/01/2012;COL
Comoros;25852;2221;23631;2012;1;1;01/01/2012;COM
Congo;77557;6662;70895;2012;1;1;01/01/2012;COG
Costa Rica;878979;75502;803477;2012;1;1;01/01/2012;CRI
Côte d’Ivoire;258523;22206;236317;2012;1;1;01/01/2012;CIV
Croatia;2507674;215404;2292270;2012;1;1;01/01/2012;HRV
Cuba;1835514;157667;1677847;2012;1;1;01/01/2012;CUB
Cyprus;1189206;102150;1087056;2012;1;1;01/01/2012;CYP
Czech Republic;9022456;775009;8247447;2012;1;1;01/01/2012;CZE
Democratic People’s Republic of Korea;180966;15545;165421;2012;1;1;01/01/2012;PRK
Democratic Republic of the Congo;77557;6662;70895;2012;1;1;01/01/2012;ZAR
Denmark;19027299;1634403;17392896;2012;1;1;01/01/2012;DNK
Djibouti;25852;2221;23631;2012;1;1;01/01/2012;DJI
Dominica;25852;2221;23631;2012;1;1;01/01/2012;DMA
Dominican Republic;1085797;93267;992530;2012;1;1;01/01/2012;DOM
Ecuador;1034092;88826;945266;2012;1;1;01/01/2012;ECU
Egypt;2430117;208742;2221375;2012;1;1;01/01/2012;EGY
El Salvador;491194;42192;449002;2012;1;1;01/01/2012;SLV
Equatorial Guinea;206819;17765;189054;2012;1;1;01/01/2012;GNQ
Eritrea;25852;2221;23631;2012;1;1;01/01/2012;ERI
Estonia;1034092;88826;945266;2012;1;1;01/01/2012;EST
Ethiopia;206819;17765;189054;2012;1;1;01/01/2012;ETH
Fiji;103409;8883;94526;2012;1;1;01/01/2012;FJI
Finland;14632406;1256891;13375515;2012;1;1;01/01/2012;FIN
France;158293682;13597077;144696605;2012;1;1;01/01/2012;FRA
Gabon;361932;31089;330843;2012;1;1;01/01/2012;GAB
Gambia;25852;2221;23631;2012;1;1;01/01/2012;GMB
Georgia;155114;13324;141790;2012;1;1;01/01/2012;GEO
Germany;207283806;17805220;189478586;2012;1;1;01/01/2012;DEU
Ghana;155114;13324;141790;2012;1;1;01/01/2012;GHA
Greece;17863945;1534473;16329472;2012;1;1;01/01/2012;GRC
Grenada;25852;2221;23631;2012;1;1;01/01/2012;GRD
Guatemala;723865;62178;661687;2012;1;1;01/01/2012;GTM
Guinea;51705;4441;47264;2012;1;1;01/01/2012;GIN
Guinea-Bissau;25852;2221;23631;2012;1;1;01/01/2012;GNB
Guyana;25852;2221;23631;2012;1;1;01/01/2012;GUY
Haiti;77557;6662;70895;2012;1;1;01/01/2012;HTI
Honduras;206819;17765;189054;2012;1;1;01/01/2012;HND
Hungary;7523022;646211;6876811;2012;1;1;01/01/2012;HUN
Iceland;1085797;93267;992530;2012;1;1;01/01/2012;ISL
India;13805133;1185830;12619303;2012;1;1;01/01/2012;IND
Iran (Islamic Republic of);6023588;517413;5506175;2012;1;1;01/01/2012;IRN
Iraq;517046;44413;472633;2012;1;1;01/01/2012;IRQ
Ireland;12874449;1105887;11768562;2012;1;1;01/01/2012;IRL
Israel;9927286;852732;9074554;2012;1;1;01/01/2012;ISR
Italy;129235688;11101059;118134629;2012;1;1;01/01/2012;ITA
Jamaica;361932;31089;330843;2012;1;1;01/01/2012;JAM
Japan;323929419;27824820;296104599;2012;1;1;01/01/2012;JPN
Jordan;361932;31089;330843;2012;1;1;01/01/2012;JOR
Kazakhstan;1964775;168770;1796005;2012;1;1;01/01/2012;KAZ
Kenya;310228;26648;283580;2012;1;1;01/01/2012;KEN
Kiribati;25852;2221;23631;2012;1;1;01/01/2012;KIR
Kuwait;6799157;584032;6215125;2012;1;1;01/01/2012;KWT
Kyrgyzstan;25852;2221;23631;2012;1;1;01/01/2012;KGZ
Lao People’s Democratic Republic;25852;2221;23631;2012;1;1;01/01/2012;LAO
Latvia;982388;84385;898003;2012;1;1;01/01/2012;LVA
Lebanon;853126;73282;779844;2012;1;1;01/01/2012;LBN
Lesotho;25852;2221;23631;2012;1;1;01/01/2012;LSO
Liberia;25852;2221;23631;2012;1;1;01/01/2012;LBR
Libya;3334948;286465;3048483;2012;1;1;01/01/2012;LBY
Liechtenstein;232671;19986;212685;2012;1;1;01/01/2012;LIE
Lithuania;1680400;144343;1536057;2012;1;1;01/01/2012;LTU
Luxembourg;2326708;199859;2126849;2012;1;1;01/01/2012;LUX
Madagascar;77557;6662;70895;2012;1;1;01/01/2012;MDG
Malawi;25852;2221;23631;2012;1;1;01/01/2012;MWI
Malaysia;6540634;561826;5978808;2012;1;1;01/01/2012;MYS
Maldives;25852;2221;23631;2012;1;1;01/01/2012;MDV
Mali;77557;6662;70895;2012;1;1;01/01/2012;MLI
Malta;439489;37751;401738;2012;1;1;01/01/2012;MLT
Marshall Islands;25852;2221;23631;2012;1;1;01/01/2012;MHL
Mauritania;25852;2221;23631;2012;1;1;01/01/2012;MRT
Mauritius;284375;24427;259948;2012;1;1;01/01/2012;MUS
Mexico;60908038;5231865;55676173;2012;1;1;01/01/2012;MEX
Micronesia (Federated States of);25852;2221;23631;2012;1;1;01/01/2012;FSM
Monaco;77557;6662;70895;2012;1;1;01/01/2012;MCO
Mongolia;51705;4441;47264;2012;1;1;01/01/2012;MNG
Montenegro;103409;8883;94526;2012;1;1;01/01/2012;MNE
Morocco;1499434;128798;1370636;2012;1;1;01/01/2012;MAR
Mozambique;77557;6662;70895;2012;1;1;01/01/2012;MOZ
Myanmar;155114;13324;141790;2012;1;1;01/01/2012;MMR
Namibia;206819;17765;189054;2012;1;1;01/01/2012;NAM
Nauru;25852;2221;23631;2012;1;1;01/01/2012;NRU
Nepal;155114;13324;141790;2012;1;1;01/01/2012;NPL
Netherlands;47956031;4119317;43836714;2012;1;1;01/01/2012;NLD
New Zealand;7057680;606239;6451441;2012;1;1;01/01/2012;NZL
Nicaragua;77557;6662;70895;2012;1;1;01/01/2012;NIC
Niger;51705;4441;47264;2012;1;1;01/01/2012;NER
Nigeria;2016480;173211;1843269;2012;1;1;01/01/2012;NGA
Norway;22517360;1934191;20583169;2012;1;1;01/01/2012;NOR
Oman;2223299;190976;2032323;2012;1;1;01/01/2012;OMN
Pakistan;2119889;182094;1937795;2012;1;1;01/01/2012;PAK
Palau;25852;2221;23631;2012;1;1;01/01/2012;PLW
Panama;568751;48854;519897;2012;1;1;01/01/2012;PAN
Papua New Guinea;51705;4441;47264;2012;1;1;01/01/2012;PNG
Paraguay;180966;15545;165421;2012;1;1;01/01/2012;PRY
Peru;2326708;199859;2126849;2012;1;1;01/01/2012;PER
Philippines;2326708;199859;2126849;2012;1;1;01/01/2012;PHL
Poland;21405711;1838703;19567008;2012;1;1;01/01/2012;POL
Portugal;13210529;1134755;12075774;2012;1;1;01/01/2012;PRT
Qatar;3490062;299788;3190274;2012;1;1;01/01/2012;QAT
Republic of Korea;58426216;5018682;53407534;2012;1;1;01/01/2012;KOR
Moldova;51705;4441;47264;2012;1;1;01/01/2012;MDA
Romania;4575859;393056;4182803;2012;1;1;01/01/2012;ROM
Russian Federation;41415397;3557491;37857906;2012;1;1;01/01/2012;RUS
Rwanda;25852;2221;23631;2012;1;1;01/01/2012;RWA
Saint Kitts and Nevis;25852;2221;23631;2012;1;1;01/01/2012;KN1
Saint Lucia;25852;2221;23631;2012;1;1;01/01/2012;LCA
Saint Vincent and the Grenadines;25852;2221;23631;2012;1;1;01/01/2012;VCT
Samoa;25852;2221;23631;2012;1;1;01/01/2012;WSM
San Marino;77557;6662;70895;2012;1;1;01/01/2012;SMR
Sao Tome and Principe;25852;2221;23631;2012;1;1;01/01/2012;STP
Saudi Arabia;21457416;1843144;19614272;2012;1;1;01/01/2012;SAU
Senegal;155114;13324;141790;2012;1;1;01/01/2012;SEN
Serbia;956535;82164;874371;2012;1;1;01/01/2012;SER
Seychelles;51705;4441;47264;2012;1;1;01/01/2012;SYC
Sierra Leone;25852;2221;23631;2012;1;1;01/01/2012;SLE
Singapore;8660523;743920;7916603;2012;1;1;01/01/2012;SGP
Slovakia;3671028;315333;3355695;2012;1;1;01/01/2012;SVK
Slovenia;2662788;228727;2434061;2012;1;1;01/01/2012;SVN
Solomon Islands;25852;2221;23631;2012;1;1;01/01/2012;SLB
Somalia;25852;2221;23631;2012;1;1;01/01/2012;SOM
South Africa;9953139;854952;9098187;2012;1;1;01/01/2012;ZAF
Spain;82132783;7055024;75077759;2012;1;1;01/01/2012;ESP
Sri Lanka;491194;42192;449002;2012;1;1;01/01/2012;LKA
Sudan;258523;22206;236317;2012;1;1;01/01/2012;SDN
Suriname;77557;6662;70895;2012;1;1;01/01/2012;SUR
Swaziland;77557;6662;70895;2012;1;1;01/01/2012;SWZ
Sweden;27506856;2362778;25144078;2012;1;1;01/01/2012;SWE
Switzerland;29213108;2509341;26703767;2012;1;1;01/01/2012;CHE
Syrian Arab Republic;646308;55516;590792;2012;1;1;01/01/2012;SYR
Tajikistan;51705;4441;47264;2012;1;1;01/01/2012;TJK
Thailand;5403132;464117;4939015;2012;1;1;01/01/2012;THA
North Macedonia;180966;15545;165421;2012;1;1;01/01/2012;MKD
Timor-Leste;25852;2221;23631;2012;1;1;01/01/2012;TMP
Togo;25852;2221;23631;2012;1;1;01/01/2012;TGO
Tonga;25852;2221;23631;2012;1;1;01/01/2012;TON
Trinidad and Tobago;1137502;97709;1039793;2012;1;1;01/01/2012;TTO
Tunisia;775569;66620;708949;2012;1;1;01/01/2012;TUN
Turkey;15950874;1370145;14580729;2012;1;1;01/01/2012;TUR
Turkmenistan;672160;57737;614423;2012;1;1;01/01/2012;TKM
Tuvalu;25852;2221;23631;2012;1;1;01/01/2012;TUV
Uganda;155114;13324;141790;2012;1;1;01/01/2012;UGA
Ukraine;2249151;193197;2055954;2012;1;1;01/01/2012;UKR
United Arab Emirates;10108253;868276;9239977;2012;1;1;01/01/2012;ARE
United Kingdom of Great Britain and  Northern Ireland;170728642;14665212;156063430;2012;1;1;01/01/2012;GBR
United Republic of Tanzania;206819;17765;189054;2012;1;1;01/01/2012;TZA
United States of America;568750776;a;568750776;2012;1;1;01/01/2012;USA
Uruguay;698012;59958;638054;2012;1;1;01/01/2012;URY
Uzbekistan;258523;22206;236317;2012;1;1;01/01/2012;UZB
Vanuatu;25852;2221;23631;2012;1;1;01/01/2012;VUT
Venezuela;8117625;697286;7420339;2012;1;1;01/01/2012;VEN
Viet Nam;853126;73282;779844;2012;1;1;01/01/2012;VNM
Yemen;258523;22206;236317;2012;1;1;01/01/2012;YEM
Zambia;103409;8883;94526;2012;1;1;01/01/2012;ZMB
Zimbabwe;77557;6662;70895;2012;1;1;01/01/2012;ZWE
Indonesia;6152849;528516;5624333;2012;1;1;01/01/2012;IDN
Afghanistan;105942;11994;93948;2011;1;1;01/01/2011;AFG
Albania;264854;29985;234869;2011;1;1;01/01/2011;ALB
Algeria;3390130;383806;3006324;2011;1;1;01/01/2011;DZA
Andorra;185398;20989;164409;2011;1;1;01/01/2011;AND
Angola;264854;29985;234869;2011;1;1;01/01/2011;AGO
Antigua and Barbuda;52971;5997;46974;2011;1;1;01/01/2011;ATG
Argentina;7601306;860565;6740741;2011;1;1;01/01/2011;ARG
Armenia;132427;14993;117434;2011;1;1;01/01/2011;ARM
Australia;51196253;5796069;45400184;2011;1;1;01/01/2011;AUS
Austria;22539064;2551710;19987354;2011;1;1;01/01/2011;AUT
Azerbaijan;397281;44977;352304;2011;1;1;01/01/2011;AZE
Bahamas;476737;53973;422764;2011;1;1;01/01/2011;BHS
Bahrain;1032930;116941;915989;2011;1;1;01/01/2011;BHR
Bangladesh;264854;29985;234869;2011;1;1;01/01/2011;BGD
Barbados;211883;23988;187895;2011;1;1;01/01/2011;BRB
Belarus;1112386;125936;986450;2011;1;1;01/01/2011;BLR
Belgium;28471791;3223370;25248421;2011;1;1;01/01/2011;BEL
Belize;26485;2998;23487;2011;1;1;01/01/2011;BLZ
Benin;79456;8996;70460;2011;1;1;01/01/2011;BEN
Bhutan;26485;2998;23487;2011;1;1;01/01/2011;BTN
Bolivia;185398;20989;164409;2011;1;1;01/01/2011;BOL
Bosnia and Herzegovina;370796;41979;328817;2011;1;1;01/01/2011;BIH
Botswana;476737;53973;422764;2011;1;1;01/01/2011;BWA
Brazil;42667959;4830557;37837402;2011;1;1;01/01/2011;BRA
Brunei Darussalam;741591;83958;657633;2011;1;1;01/01/2011;BRN
Bulgaria;1006445;113942;892503;2011;1;1;01/01/2011;BGR
Burkina Faso;79456;8996;70460;2011;1;1;01/01/2011;BFA
Burundi;26485;2998;23487;2011;1;1;01/01/2011;BDI
Cambodia;79456;8996;70460;2011;1;1;01/01/2011;KHM
Cameroon;291339;32983;258356;2011;1;1;01/01/2011;CMR
Canada;84938636;9616137;75322499;2011;1;1;01/01/2011;CAN
Cape Verde;26485;2998;23487;2011;1;1;01/01/2011;CPV
Central African Republic;26485;2998;23487;2011;1;1;01/01/2011;CAF
Chad;52971;5997;46974;2011;1;1;01/01/2011;TCD
Chile;6250551;707642;5542909;2011;1;1;01/01/2011;CHL
China;84461899;9562164;74899735;2011;1;1;01/01/2011;CHN
Colombia;3813896;431782;3382114;2011;1;1;01/01/2011;COL
Comoros;26485;2998;23487;2011;1;1;01/01/2011;COM
Congo;79456;8996;70460;2011;1;1;01/01/2011;COG
Costa Rica;900503;101949;798554;2011;1;1;01/01/2011;CRI
Côte d’Ivoire;264854;29985;234869;2011;1;1;01/01/2011;CIV
Croatia;2569083;290853;2278230;2011;1;1;01/01/2011;HRV
Cuba;1880463;212892;1667571;2011;1;1;01/01/2011;CUB
Cyprus;1218328;137930;1080398;2011;1;1;01/01/2011;CYP
Czech Republic;9243400;1046471;8196929;2011;1;1;01/01/2011;CZE
Democratic People’s Republic of Korea;185398;20989;164409;2011;1;1;01/01/2011;PRK
Democratic Republic of the Congo;79456;8996;70460;2011;1;1;01/01/2011;ZAR
Denmark;19493245;2206884;17286361;2011;1;1;01/01/2011;DNK
Djibouti;26485;2998;23487;2011;1;1;01/01/2011;DJI
Dominica;26485;2998;23487;2011;1;1;01/01/2011;DMA
Dominican Republic;1112386;125936;986450;2011;1;1;01/01/2011;DOM
Ecuador;1059416;119939;939477;2011;1;1;01/01/2011;ECU
Egypt;2489626;281858;2207768;2011;1;1;01/01/2011;EGY
El Salvador;503222;56971;446251;2011;1;1;01/01/2011;SLV
Equatorial Guinea;211883;23988;187895;2011;1;1;01/01/2011;GNQ
Eritrea;26485;2998;23487;2011;1;1;01/01/2011;ERI
Estonia;1059416;119939;939477;2011;1;1;01/01/2011;EST
Ethiopia;211883;23988;187895;2011;1;1;01/01/2011;ETH
Fiji;105942;11994;93948;2011;1;1;01/01/2011;FJI
Finland;14990729;1697142;13293587;2011;1;1;01/01/2011;FIN
France;162170025;18359715;143810310;2011;1;1;01/01/2011;FRA
Gabon;370796;41979;328817;2011;1;1;01/01/2011;GAB
Gambia;26485;2998;23487;2011;1;1;01/01/2011;GMB
Georgia;158912;17991;140921;2011;1;1;01/01/2011;GEO
Germany;212359833;24041841;188317992;2011;1;1;01/01/2011;DEU
Ghana;158912;17991;140921;2011;1;1;01/01/2011;GHA
Greece;18301403;2071952;16229451;2011;1;1;01/01/2011;GRC
Grenada;26485;2998;23487;2011;1;1;01/01/2011;GRD
Guatemala;741591;83958;657633;2011;1;1;01/01/2011;GTM
Guinea;52971;5997;46974;2011;1;1;01/01/2011;GIN
Guinea-Bissau;26485;2998;23487;2011;1;1;01/01/2011;GNB
Guyana;26485;2998;23487;2011;1;1;01/01/2011;GUY
Haiti;79456;8996;70460;2011;1;1;01/01/2011;HTI
Honduras;211883;23988;187895;2011;1;1;01/01/2011;HND
Hungary;7707248;872559;6834689;2011;1;1;01/01/2011;HUN
Iceland;1112386;125936;986450;2011;1;1;01/01/2011;ISL
India;14143197;1601190;12542007;2011;1;1;01/01/2011;IND
Iran (Islamic Republic of);6171095;698647;5472448;2011;1;1;01/01/2011;IRN
Iraq;529708;59970;469738;2011;1;1;01/01/2011;IRQ
Ireland;13189723;1493245;11696478;2011;1;1;01/01/2011;IRL
Israel;10170389;1151418;9018971;2011;1;1;01/01/2011;ISR
Italy;132400450;14989419;117411031;2011;1;1;01/01/2011;ITA
Jamaica;370796;41979;328817;2011;1;1;01/01/2011;JAM
Japan;331861899;37570998;294290901;2011;1;1;01/01/2011;JPN
Jordan;370796;41979;328817;2011;1;1;01/01/2011;JOR
Kazakhstan;2012889;227885;1785004;2011;1;1;01/01/2011;KAZ
Kenya;317825;35982;281843;2011;1;1;01/01/2011;KEN
Kiribati;26485;2998;23487;2011;1;1;01/01/2011;KIR
Kuwait;6965657;788601;6177056;2011;1;1;01/01/2011;KWT
Kyrgyzstan;26485;2998;23487;2011;1;1;01/01/2011;KGZ
Lao People’s Democratic Republic;26485;2998;23487;2011;1;1;01/01/2011;LAO
Latvia;1006445;113942;892503;2011;1;1;01/01/2011;LVA
Lebanon;874018;98950;775068;2011;1;1;01/01/2011;LBN
Lesotho;26485;2998;23487;2011;1;1;01/01/2011;LSO
Liberia;26485;2998;23487;2011;1;1;01/01/2011;LBR
Libya;3416615;386805;3029810;2011;1;1;01/01/2011;LBY
Liechtenstein;238369;26986;211383;2011;1;1;01/01/2011;LIE
Lithuania;1721550;194902;1526648;2011;1;1;01/01/2011;LTU
Luxembourg;2383685;269864;2113821;2011;1;1;01/01/2011;LUX
Madagascar;79456;8996;70460;2011;1;1;01/01/2011;MDG
Malawi;26485;2998;23487;2011;1;1;01/01/2011;MWI
Malaysia;6700803;758616;5942187;2011;1;1;01/01/2011;MYS
Maldives;26485;2998;23487;2011;1;1;01/01/2011;MDV
Mali;79456;8996;70460;2011;1;1;01/01/2011;MLI
Malta;450252;50974;399278;2011;1;1;01/01/2011;MLT
Marshall Islands;26485;2998;23487;2011;1;1;01/01/2011;MHL
Mauritania;26485;2998;23487;2011;1;1;01/01/2011;MRT
Mauritius;291339;32983;258356;2011;1;1;01/01/2011;MUS
Mexico;62399572;7064427;55335145;2011;1;1;01/01/2011;MEX
Micronesia (Federated States of);26485;2998;23487;2011;1;1;01/01/2011;FSM
Monaco;79456;8996;70460;2011;1;1;01/01/2011;MCO
Mongolia;52971;5997;46974;2011;1;1;01/01/2011;MNG
Montenegro;105942;11994;93948;2011;1;1;01/01/2011;MNE
Morocco;1536153;173912;1362241;2011;1;1;01/01/2011;MAR
Mozambique;79456;8996;70460;2011;1;1;01/01/2011;MOZ
Myanmar;158912;17991;140921;2011;1;1;01/01/2011;MMR
Namibia;211883;23988;187895;2011;1;1;01/01/2011;NAM
Nauru;26485;2998;23487;2011;1;1;01/01/2011;NRU
Nepal;158912;17991;140921;2011;1;1;01/01/2011;NPL
Netherlands;49130393;5562187;43568206;2011;1;1;01/01/2011;NLD
New Zealand;7230511;818586;6411925;2011;1;1;01/01/2011;NZL
Nicaragua;79456;8996;70460;2011;1;1;01/01/2011;NIC
Niger;52971;5997;46974;2011;1;1;01/01/2011;NER
Nigeria;2065860;233882;1831978;2011;1;1;01/01/2011;NGA
Norway;23068772;2611679;20457093;2011;1;1;01/01/2011;NOR
Oman;2277743;257870;2019873;2011;1;1;01/01/2011;OMN
Pakistan;2171802;245876;1925926;2011;1;1;01/01/2011;PAK
Palau;26485;2998;23487;2011;1;1;01/01/2011;PLW
Panama;582679;65967;516712;2011;1;1;01/01/2011;PAN
Papua New Guinea;52971;5997;46974;2011;1;1;01/01/2011;PNG
Paraguay;185398;20989;164409;2011;1;1;01/01/2011;PRY
Peru;2383685;269864;2113821;2011;1;1;01/01/2011;PER
Philippines;2383685;269864;2113821;2011;1;1;01/01/2011;PHL
Poland;21929901;2482744;19447157;2011;1;1;01/01/2011;POL
Portugal;13534033;1532225;12001808;2011;1;1;01/01/2011;PRT
Qatar;3575527;404795;3170732;2011;1;1;01/01/2011;QAT
Republic of Korea;59856975;6776573;53080402;2011;1;1;01/01/2011;KOR
Moldova;52971;5997;46974;2011;1;1;01/01/2011;MDA
Romania;4687914;530732;4157182;2011;1;1;01/01/2011;ROM
Russian Federation;42429590;4803571;37626019;2011;1;1;01/01/2011;RUS
Rwanda;26485;2998;23487;2011;1;1;01/01/2011;RWA
Saint Kitts and Nevis;26485;2998;23487;2011;1;1;01/01/2011;KN1
Saint Lucia;26485;2998;23487;2011;1;1;01/01/2011;LCA
Saint Vincent and the Grenadines;26485;2998;23487;2011;1;1;01/01/2011;VCT
Samoa;26485;2998;23487;2011;1;1;01/01/2011;WSM
San Marino;79456;8996;70460;2011;1;1;01/01/2011;SMR
Sao Tome and Principe;26485;2998;23487;2011;1;1;01/01/2011;STP
Saudi Arabia;21982871;2488741;19494130;2011;1;1;01/01/2011;SAU
Senegal;158912;17991;140921;2011;1;1;01/01/2011;SEN
Serbia;979959;110944;869015;2011;1;1;01/01/2011;SER
Seychelles;52971;5997;46974;2011;1;1;01/01/2011;SYC
Sierra Leone;26485;2998;23487;2011;1;1;01/01/2011;SLE
Singapore;8872605;1004492;7868113;2011;1;1;01/01/2011;SGP
Slovakia;3760925;425785;3335140;2011;1;1;01/01/2011;SVK
Slovenia;2727995;308844;2419151;2011;1;1;01/01/2011;SVN
Solomon Islands;26485;2998;23487;2011;1;1;01/01/2011;SLB
Somalia;26485;2998;23487;2011;1;1;01/01/2011;SOM
South Africa;10196874;1154416;9042458;2011;1;1;01/01/2011;ZAF
Spain;84144075;9526182;74617893;2011;1;1;01/01/2011;ESP
Sri Lanka;503222;56971;446251;2011;1;1;01/01/2011;LKA
Sudan;264854;29985;234869;2011;1;1;01/01/2011;SDN
Suriname;79456;8996;70460;2011;1;1;01/01/2011;SUR
Swaziland;79456;8996;70460;2011;1;1;01/01/2011;SWZ
Sweden;28180452;3190387;24990065;2011;1;1;01/01/2011;SWE
Switzerland;29928487;3388286;26540201;2011;1;1;01/01/2011;CHE
Syrian Arab Republic;662135;74962;587173;2011;1;1;01/01/2011;SYR
Tajikistan;52971;5997;46974;2011;1;1;01/01/2011;TJK
Thailand;5535446;626683;4908763;2011;1;1;01/01/2011;THA
North Macedonia;185398;20989;164409;2011;1;1;01/01/2011;MKD
Timor-Leste;26485;2998;23487;2011;1;1;01/01/2011;TMP
Togo;26485;2998;23487;2011;1;1;01/01/2011;TGO
Tonga;26485;2998;23487;2011;1;1;01/01/2011;TON
Trinidad and Tobago;1165357;131933;1033424;2011;1;1;01/01/2011;TTO
Tunisia;794562;89955;704607;2011;1;1;01/01/2011;TUN
Turkey;16341484;1850064;14491420;2011;1;1;01/01/2011;TUR
Turkmenistan;688620;77961;610659;2011;1;1;01/01/2011;TKM
Tuvalu;26485;2998;23487;2011;1;1;01/01/2011;TUV
Uganda;158912;17991;140921;2011;1;1;01/01/2011;UGA
Ukraine;2304229;260868;2043361;2011;1;1;01/01/2011;UKR
United Arab Emirates;10355786;1172407;9183379;2011;1;1;01/01/2011;ARE
United Kingdom of Great Britain and  Northern Ireland;174909496;19801985;155107511;2011;1;1;01/01/2011;GBR
United Republic of Tanzania;211883;23988;187895;2011;1;1;01/01/2011;TZA
United States of America;582678514;a;582678514;2011;1;1;01/01/2011;USA
Uruguay;715106;80959;634147;2011;1;1;01/01/2011;URY
Uzbekistan;264854;29985;234869;2011;1;1;01/01/2011;UZB
Vanuatu;26485;2998;23487;2011;1;1;01/01/2011;VUT
Venezuela;8316412;941524;7374888;2011;1;1;01/01/2011;VEN
Viet Nam;874018;98950;775068;2011;1;1;01/01/2011;VNM
Yemen;264854;29985;234869;2011;1;1;01/01/2011;YEM
Zambia;105942;11994;93948;2011;1;1;01/01/2011;ZMB
Zimbabwe;79456;8996;70460;2011;1;1;01/01/2011;ZWE
Indonesia;6303522;713639;5589883;2011;1;1;01/01/2011;IDN
Afghanistan;94024;9440;84584;2010;1;1;01/01/2010;AFG
Albania;235061;23601;211460;2010;1;1;01/01/2010;ALB
Algeria;3008777;302088;2706689;2010;1;1;01/01/2010;DZA
Andorra;164543;16520;148023;2010;1;1;01/01/2010;AND
Angola;235061;23601;211460;2010;1;1;01/01/2010;AGO
Antigua and Barbuda;47012;4720;42292;2010;1;1;01/01/2010;ATG
Argentina;6746242;677338;6068904;2010;1;1;01/01/2010;ARG
Armenia;117530;11800;105730;2010;1;1;01/01/2010;ARM
Australia;45437230;4561999;40875231;2010;1;1;01/01/2010;AUS
Austria;20003664;2008412;17995252;2010;1;1;01/01/2010;AUT
Azerbaijan;352591;35401;317190;2010;1;1;01/01/2010;AZE
Bahamas;423109;42481;380628;2010;1;1;01/01/2010;BHS
Bahrain;916737;92042;824695;2010;1;1;01/01/2010;BHR
Bangladesh;235061;23601;211460;2010;1;1;01/01/2010;BGD
Barbados;188049;18881;169168;2010;1;1;01/01/2010;BRB
Belarus;987255;99123;888132;2010;1;1;01/01/2010;BLR
Belgium;25269024;2537066;22731958;2010;1;1;01/01/2010;BEL
Belize;23506;2360;21146;2010;1;1;01/01/2010;BLZ
Benin;70518;7080;63438;2010;1;1;01/01/2010;BEN
Bhutan;23506;2360;21146;2010;1;1;01/01/2010;BTN
Bolivia;164543;16520;148023;2010;1;1;01/01/2010;BOL
Bosnia and Herzegovina;329085;33041;296044;2010;1;1;01/01/2010;BIH
Botswana;423109;42481;380628;2010;1;1;01/01/2010;BWA
Brazil;37868276;3802059;34066217;2010;1;1;01/01/2010;BRA
Brunei Darussalam;658170;66082;592088;2010;1;1;01/01/2010;BRN
Bulgaria;893231;89682;803549;2010;1;1;01/01/2010;BGR
Burkina Faso;70518;7080;63438;2010;1;1;01/01/2010;BFA
Burundi;23506;2360;21146;2010;1;1;01/01/2010;BDI
Cambodia;70518;7080;63438;2010;1;1;01/01/2010;KHM
Cameroon;258567;25961;232606;2010;1;1;01/01/2010;CMR
Canada;75383962;7568717;67815245;2010;1;1;01/01/2010;CAN
Cape Verde;23506;2360;21146;2010;1;1;01/01/2010;CPV
Central African Republic;23506;2360;21146;2010;1;1;01/01/2010;CAF
Chad;47012;4720;42292;2010;1;1;01/01/2010;TCD
Chile;5547432;556975;4990457;2010;1;1;01/01/2010;CHL
China;74960853;7526236;67434617;2010;1;1;01/01/2010;CHN
Colombia;3384874;339849;3045025;2010;1;1;01/01/2010;COL
Comoros;23506;2360;21146;2010;1;1;01/01/2010;COM
Congo;70518;7080;63438;2010;1;1;01/01/2010;COG
Costa Rica;799206;80242;718964;2010;1;1;01/01/2010;CRI
Côte d’Ivoire;235061;23601;211460;2010;1;1;01/01/2010;CIV
Croatia;2280089;228926;2051163;2010;1;1;01/01/2010;HRV
Cuba;1668931;167564;1501367;2010;1;1;01/01/2010;CUB
Cyprus;1081279;108563;972716;2010;1;1;01/01/2010;CYP
Czech Republic;8203618;823661;7379957;2010;1;1;01/01/2010;CZE
Democratic People’s Republic of Korea;164543;16520;148023;2010;1;1;01/01/2010;PRK
Democratic Republic of the Congo;70518;7080;63438;2010;1;1;01/01/2010;ZAR
Denmark;17300466;1737005;15563461;2010;1;1;01/01/2010;DNK
Djibouti;23506;2360;21146;2010;1;1;01/01/2010;DJI
Dominica;23506;2360;21146;2010;1;1;01/01/2010;DMA
Dominican Republic;987255;99123;888132;2010;1;1;01/01/2010;DOM
Ecuador;940243;94402;845841;2010;1;1;01/01/2010;ECU
Egypt;2209570;221846;1987724;2010;1;1;01/01/2010;EGY
El Salvador;446615;44841;401774;2010;1;1;01/01/2010;SLV
Equatorial Guinea;188049;18881;169168;2010;1;1;01/01/2010;GNQ
Eritrea;23506;2360;21146;2010;1;1;01/01/2010;ERI
Estonia;940243;94402;845841;2010;1;1;01/01/2010;EST
Ethiopia;188049;18881;169168;2010;1;1;01/01/2010;ETH
Fiji;94024;9440;84584;2010;1;1;01/01/2010;FJI
Finland;13304435;1335795;11968640;2010;1;1;01/01/2010;FIN
France;143927658;14450657;129477001;2010;1;1;01/01/2010;FRA
Gabon;329085;33041;296044;2010;1;1;01/01/2010;GAB
Gambia;23506;2360;21146;2010;1;1;01/01/2010;GMB
Georgia;141036;14160;126876;2010;1;1;01/01/2010;GEO
Germany;188471657;18922973;169548684;2010;1;1;01/01/2010;DEU
Ghana;141036;14160;126876;2010;1;1;01/01/2010;GHA
Greece;16242693;1630803;14611890;2010;1;1;01/01/2010;GRC
Grenada;23506;2360;21146;2010;1;1;01/01/2010;GRD
Guatemala;658170;66082;592088;2010;1;1;01/01/2010;GTM
Guinea;47012;4720;42292;2010;1;1;01/01/2010;GIN
Guinea-Bissau;23506;2360;21146;2010;1;1;01/01/2010;GNB
Guyana;23506;2360;21146;2010;1;1;01/01/2010;GUY
Haiti;70518;7080;63438;2010;1;1;01/01/2010;HTI
Honduras;188049;18881;169168;2010;1;1;01/01/2010;HND
Hungary;6840266;686778;6153488;2010;1;1;01/01/2010;HUN
Iceland;987255;99123;888132;2010;1;1;01/01/2010;ISL
India;12552241;1260273;11291968;2010;1;1;01/01/2010;IND
Iran (Islamic Republic of);5476914;549894;4927020;2010;1;1;01/01/2010;IRN
Iraq;470121;47201;422920;2010;1;1;01/01/2010;IRQ
Ireland;11706022;1175311;10530711;2010;1;1;01/01/2010;IRL
Israel;9026330;906264;8120066;2010;1;1;01/01/2010;ISR
Italy;117506837;11797947;105708890;2010;1;1;01/01/2010;ITA
Jamaica;329085;33041;296044;2010;1;1;01/01/2010;JAM
Japan;294531038;29571571;264959467;2010;1;1;01/01/2010;JPN
Jordan;329085;33041;296044;2010;1;1;01/01/2010;JOR
Kazakhstan;1786461;179365;1607096;2010;1;1;01/01/2010;KAZ
Kenya;282073;28321;253752;2010;1;1;01/01/2010;KEN
Kiribati;23506;2360;21146;2010;1;1;01/01/2010;KIR
Kuwait;6182096;620696;5561400;2010;1;1;01/01/2010;KWT
Kyrgyzstan;23506;2360;21146;2010;1;1;01/01/2010;KGZ
Lao People’s Democratic Republic;23506;2360;21146;2010;1;1;01/01/2010;LAO
Latvia;893231;89682;803549;2010;1;1;01/01/2010;LVA
Lebanon;775700;77882;697818;2010;1;1;01/01/2010;LBN
Lesotho;23506;2360;21146;2010;1;1;01/01/2010;LSO
Liberia;23506;2360;21146;2010;1;1;01/01/2010;LBR
Libya;3032283;304448;2727835;2010;1;1;01/01/2010;LBY
Liechtenstein;211555;21241;190314;2010;1;1;01/01/2010;LIE
Lithuania;1527895;153404;1374491;2010;1;1;01/01/2010;LTU
Luxembourg;2115546;212406;1903140;2010;1;1;01/01/2010;LUX
Madagascar;70518;7080;63438;2010;1;1;01/01/2010;MDG
Malawi;23506;2360;21146;2010;1;1;01/01/2010;MWI
Malaysia;5947035;597096;5349939;2010;1;1;01/01/2010;MYS
Maldives;23506;2360;21146;2010;1;1;01/01/2010;MDV
Mali;70518;7080;63438;2010;1;1;01/01/2010;MLI
Malta;399603;40121;359482;2010;1;1;01/01/2010;MLT
Marshall Islands;23506;2360;21146;2010;1;1;01/01/2010;MHL
Mauritania;23506;2360;21146;2010;1;1;01/01/2010;MRT
Mauritius;258567;25961;232606;2010;1;1;01/01/2010;MUS
Mexico;55380297;5560305;49819992;2010;1;1;01/01/2010;MEX
Micronesia (Federated States of);23506;2360;21146;2010;1;1;01/01/2010;FSM
Monaco;70518;7080;63438;2010;1;1;01/01/2010;MCO
Mongolia;47012;4720;42292;2010;1;1;01/01/2010;MNG
Montenegro;94024;9440;84584;2010;1;1;01/01/2010;MNE
Morocco;1363352;136884;1226468;2010;1;1;01/01/2010;MAR
Mozambique;70518;7080;63438;2010;1;1;01/01/2010;MOZ
Myanmar;141036;14160;126876;2010;1;1;01/01/2010;MMR
Namibia;188049;18881;169168;2010;1;1;01/01/2010;NAM
Nauru;23506;2360;21146;2010;1;1;01/01/2010;NRU
Nepal;141036;14160;126876;2010;1;1;01/01/2010;NPL
Netherlands;43603757;4377914;39225843;2010;1;1;01/01/2010;NLD
New Zealand;6417157;644297;5772860;2010;1;1;01/01/2010;NZL
Nicaragua;70518;7080;63438;2010;1;1;01/01/2010;NIC
Niger;47012;4720;42292;2010;1;1;01/01/2010;NER
Nigeria;1833473;184085;1649388;2010;1;1;01/01/2010;NGA
Norway;20473786;2055614;18418172;2010;1;1;01/01/2010;NOR
Oman;2021522;202965;1818557;2010;1;1;01/01/2010;OMN
Pakistan;1927498;193525;1733973;2010;1;1;01/01/2010;PAK
Palau;23506;2360;21146;2010;1;1;01/01/2010;PLW
Panama;517134;51921;465213;2010;1;1;01/01/2010;PAN
Papua New Guinea;47012;4720;42292;2010;1;1;01/01/2010;PNG
Paraguay;164543;16520;148023;2010;1;1;01/01/2010;PRY
Peru;2115546;212406;1903140;2010;1;1;01/01/2010;PER
Philippines;2115546;212406;1903140;2010;1;1;01/01/2010;PHL
Poland;19463025;1954131;17508894;2010;1;1;01/01/2010;POL
Portugal;12011601;1205991;10805610;2010;1;1;01/01/2010;PRT
Qatar;3173319;318608;2854711;2010;1;1;01/01/2010;QAT
Republic of Korea;53123715;5333739;47789976;2010;1;1;01/01/2010;KOR
Moldova;47012;4720;42292;2010;1;1;01/01/2010;MDA
Romania;4160574;417731;3742843;2010;1;1;01/01/2010;ROM
Russian Federation;37656722;3780819;33875903;2010;1;1;01/01/2010;RUS
Rwanda;23506;2360;21146;2010;1;1;01/01/2010;RWA
Saint Kitts and Nevis;23506;2360;21146;2010;1;1;01/01/2010;KN1
Saint Lucia;23506;2360;21146;2010;1;1;01/01/2010;LCA
Saint Vincent and the Grenadines;23506;2360;21146;2010;1;1;01/01/2010;VCT
Samoa;23506;2360;21146;2010;1;1;01/01/2010;WSM
San Marino;70518;7080;63438;2010;1;1;01/01/2010;SMR
Sao Tome and Principe;23506;2360;21146;2010;1;1;01/01/2010;STP
Saudi Arabia;19510037;1958851;17551186;2010;1;1;01/01/2010;SAU
Senegal;141036;14160;126876;2010;1;1;01/01/2010;SEN
Serbia;869725;87322;782403;2010;1;1;01/01/2010;SER
Seychelles;47012;4720;42292;2010;1;1;01/01/2010;SYC
Sierra Leone;23506;2360;21146;2010;1;1;01/01/2010;SLE
Singapore;7874533;790621;7083912;2010;1;1;01/01/2010;SGP
Slovakia;3337862;335129;3002733;2010;1;1;01/01/2010;SVK
Slovenia;2421125;243086;2178039;2010;1;1;01/01/2010;SVN
Solomon Islands;23506;2360;21146;2010;1;1;01/01/2010;SLB
Somalia;23506;2360;21146;2010;1;1;01/01/2010;SOM
South Africa;9049836;908624;8141212;2010;1;1;01/01/2010;ZAF
Spain;74678780;7497915;67180865;2010;1;1;01/01/2010;ESP
Sri Lanka;446615;44841;401774;2010;1;1;01/01/2010;LKA
Sudan;235061;23601;211460;2010;1;1;01/01/2010;SDN
Suriname;70518;7080;63438;2010;1;1;01/01/2010;SUR
Swaziland;70518;7080;63438;2010;1;1;01/01/2010;SWZ
Sweden;25010457;2511105;22499352;2010;1;1;01/01/2010;SWE
Switzerland;26561857;2666870;23894987;2010;1;1;01/01/2010;CHE
Syrian Arab Republic;587652;59002;528650;2010;1;1;01/01/2010;SYR
Tajikistan;47012;4720;42292;2010;1;1;01/01/2010;TJK
Thailand;4912768;493253;4419515;2010;1;1;01/01/2010;THA
North Macedonia;164543;16520;148023;2010;1;1;01/01/2010;MKD
Timor-Leste;23506;2360;21146;2010;1;1;01/01/2010;TMP
Togo;23506;2360;21146;2010;1;1;01/01/2010;TGO
Tonga;23506;2360;21146;2010;1;1;01/01/2010;TON
Trinidad and Tobago;1034267;103843;930424;2010;1;1;01/01/2010;TTO
Tunisia;705182;70802;634380;2010;1;1;01/01/2010;TUN
Turkey;14503244;1456158;13047086;2010;1;1;01/01/2010;TUR
Turkmenistan;611158;61362;549796;2010;1;1;01/01/2010;TKM
Tuvalu;23506;2360;21146;2010;1;1;01/01/2010;TUV
Uganda;141036;14160;126876;2010;1;1;01/01/2010;UGA
Ukraine;2045028;205325;1839703;2010;1;1;01/01/2010;UKR
United Arab Emirates;9190873;922784;8268089;2010;1;1;01/01/2010;ARE
United Kingdom of Great Britain and  Northern Ireland;155234076;15585846;139648230;2010;1;1;01/01/2010;GBR
United Republic of Tanzania;188049;18881;169168;2010;1;1;01/01/2010;TZA
United States of America;517133507;a;517133507;2010;1;1;01/01/2010;USA
Uruguay;634664;63722;570942;2010;1;1;01/01/2010;URY
Uzbekistan;235061;23601;211460;2010;1;1;01/01/2010;UZB
Vanuatu;23506;2360;21146;2010;1;1;01/01/2010;VUT
Venezuela;7380906;741059;6639847;2010;1;1;01/01/2010;VEN
Viet Nam;775700;77882;697818;2010;1;1;01/01/2010;VNM
Yemen;235061;23601;211460;2010;1;1;01/01/2010;YEM
Zambia;94024;9440;84584;2010;1;1;01/01/2010;ZMB
Zimbabwe;70518;7080;63438;2010;1;1;01/01/2010;ZWE
Indonesia;5594444;561695;5032749;2010;1;1;01/01/2010;IDN
Indonesia;4378410;455941;3922469;2009;1;1;01/01/2009;IDN
Afghanistan;27195;2832;24363;2009;1;1;01/01/2009;AFG
Albania;163171;16992;146179;2009;1;1;01/01/2009;ALB
Algeria;2311583;240714;2070869;2009;1;1;01/01/2009;DZA
Andorra;217561;22655;194906;2009;1;1;01/01/2009;AND
Angola;81585;8496;73089;2009;1;1;01/01/2009;AGO
Antigua and Barbuda;54390;5664;48726;2009;1;1;01/01/2009;ATG
Argentina;8838406;920379;7918027;2009;1;1;01/01/2009;ARG
Armenia;54390;5664;48726;2009;1;1;01/01/2009;ARM
Australia;48597636;5060666;43536970;2009;1;1;01/01/2009;AUS
Austria;24122050;2511925;21610125;2009;1;1;01/01/2009;AUT
Azerbaijan;135976;14160;121816;2009;1;1;01/01/2009;AZE
Bahamas;435122;45311;389811;2009;1;1;01/01/2009;BHS
Bahrain;897438;93454;803984;2009;1;1;01/01/2009;BHR
Bangladesh;271951;28319;243632;2009;1;1;01/01/2009;BGD
Barbados;244756;25487;219269;2009;1;1;01/01/2009;BRB
Belarus;543902;56639;487263;2009;1;1;01/01/2009;BLR
Belgium;29968995;3120791;26848204;2009;1;1;01/01/2009;BEL
Belize;27195;2832;24363;2009;1;1;01/01/2009;BLZ
Benin;27195;2832;24363;2009;1;1;01/01/2009;BEN
Bhutan;27195;2832;24363;2009;1;1;01/01/2009;BTN
Bolivia;163171;16992;146179;2009;1;1;01/01/2009;BOL
Bosnia and Herzegovina;163171;16992;146179;2009;1;1;01/01/2009;BIH
Botswana;380731;39647;341084;2009;1;1;01/01/2009;BWA
Brazil;23822904;2480774;21342130;2009;1;1;01/01/2009;BRA
Brunei Darussalam;707072;73630;633442;2009;1;1;01/01/2009;BRN
Bulgaria;543902;56639;487263;2009;1;1;01/01/2009;BGR
Burkina Faso;54390;5664;48726;2009;1;1;01/01/2009;BFA
Burundi;27195;2832;24363;2009;1;1;01/01/2009;BDI
Cambodia;27195;2832;24363;2009;1;1;01/01/2009;KHM
Cameroon;244756;25487;219269;2009;1;1;01/01/2009;CMR
Canada;80959799;8430667;72529132;2009;1;1;01/01/2009;CAN
Cape Verde;27195;2832;24363;2009;1;1;01/01/2009;CPV
Central African Republic;27195;2832;24363;2009;1;1;01/01/2009;CAF
Chad;27195;2832;24363;2009;1;1;01/01/2009;TCD
Chile;4378410;455941;3922469;2009;1;1;01/01/2009;CHL
China;72529320;7552768;64976552;2009;1;1;01/01/2009;CHN
Colombia;2855485;297353;2558132;2009;1;1;01/01/2009;COL
Comoros;27195;2832;24363;2009;1;1;01/01/2009;COM
Congo;27195;2832;24363;2009;1;1;01/01/2009;COG
Costa Rica;870243;90622;779621;2009;1;1;01/01/2009;CRI
Côte d’Ivoire;244756;25487;219269;2009;1;1;01/01/2009;CIV
Croatia;1359755;141597;1218158;2009;1;1;01/01/2009;HRV
Cuba;1468535;152924;1315611;2009;1;1;01/01/2009;CUB
Cyprus;1196584;124605;1071979;2009;1;1;01/01/2009;CYP
Czech Republic;7641822;795773;6846049;2009;1;1;01/01/2009;CZE
Democratic People’s Republic of Korea;190366;19824;170542;2009;1;1;01/01/2009;PRK
Democratic Republic of the Congo;81585;8496;73089;2009;1;1;01/01/2009;ZAR
Denmark;20097176;2092799;18004377;2009;1;1;01/01/2009;DNK
Djibouti;27195;2832;24363;2009;1;1;01/01/2009;DJI
Dominica;27195;2832;24363;2009;1;1;01/01/2009;DMA
Dominican Republic;652682;67966;584716;2009;1;1;01/01/2009;DOM
Ecuador;571097;59471;511626;2009;1;1;01/01/2009;ECU
Egypt;2393168;249210;2143958;2009;1;1;01/01/2009;EGY
El Salvador;543902;56639;487263;2009;1;1;01/01/2009;SLV
Equatorial Guinea;54390;5664;48726;2009;1;1;01/01/2009;GNQ
Eritrea;27195;2832;24363;2009;1;1;01/01/2009;ERI
Estonia;435122;45311;389811;2009;1;1;01/01/2009;EST
Ethiopia;81585;8496;73089;2009;1;1;01/01/2009;ETH
Fiji;81585;8496;73089;2009;1;1;01/01/2009;FJI
Finland;15338034;1597211;13740823;2009;1;1;01/01/2009;FIN
France;171356297;17844016;153512281;2009;1;1;01/01/2009;FRA
Gabon;217561;22655;194906;2009;1;1;01/01/2009;GAB
Gambia;27195;2832;24363;2009;1;1;01/01/2009;GMB
Georgia;81585;8496;73089;2009;1;1;01/01/2009;GEO
Germany;233252334;24289498;208962836;2009;1;1;01/01/2009;DEU
Ghana;108780;11327;97453;2009;1;1;01/01/2009;GHA
Greece;16208277;1687833;14520444;2009;1;1;01/01/2009;GRC
Grenada;27195;2832;24363;2009;1;1;01/01/2009;GRD
Guatemala;870243;90622;779621;2009;1;1;01/01/2009;GTM
Guinea;27195;2832;24363;2009;1;1;01/01/2009;GIN
Guinea-Bissau;27195;2832;24363;2009;1;1;01/01/2009;GNB
Guyana;27195;2832;24363;2009;1;1;01/01/2009;GUY
Haiti;54390;5664;48726;2009;1;1;01/01/2009;HTI
Honduras;135976;14160;121816;2009;1;1;01/01/2009;HND
Hungary;6635603;690992;5944611;2009;1;1;01/01/2009;HUN
Iceland;1006219;104782;901437;2009;1;1;01/01/2009;ISL
India;12237793;1274370;10963423;2009;1;1;01/01/2009;IND
Iran (Islamic Republic of);4895117;509748;4385369;2009;1;1;01/01/2009;IRN
Iraq;407926;42479;365447;2009;1;1;01/01/2009;IRQ
Ireland;12101818;1260211;10841607;2009;1;1;01/01/2009;IRL
Israel;11394745;1186580;10208165;2009;1;1;01/01/2009;ISR
Italy;138123890;14383393;123740497;2009;1;1;01/01/2009;ITA
Jamaica;271951;28319;243632;2009;1;1;01/01/2009;JAM
Japan;452091268;47078071;405013197;2009;1;1;01/01/2009;JPN
Jordan;326341;33983;292358;2009;1;1;01/01/2009;JOR
Kazakhstan;788658;82126;706532;2009;1;1;01/01/2009;KAZ
Kenya;271951;28319;243632;2009;1;1;01/01/2009;KEN
Kiribati;27195;2832;24363;2009;1;1;01/01/2009;KIR
Kuwait;4949507;515412;4434095;2009;1;1;01/01/2009;KWT
Kyrgyzstan;27195;2832;24363;2009;1;1;01/01/2009;KGZ
Lao People’s Democratic Republic;27195;2832;24363;2009;1;1;01/01/2009;LAO
Latvia;489512;50975;438537;2009;1;1;01/01/2009;LVA
Lebanon;924633;96286;828347;2009;1;1;01/01/2009;LBN
Lesotho;27195;2832;24363;2009;1;1;01/01/2009;LSO
Liberia;27195;2832;24363;2009;1;1;01/01/2009;LBR
Libya;1686096;175580;1510516;2009;1;1;01/01/2009;LBY
Liechtenstein;271951;28319;243632;2009;1;1;01/01/2009;LIE
Lithuania;843048;87790;755258;2009;1;1;01/01/2009;LTU
Luxembourg;2311583;240714;2070869;2009;1;1;01/01/2009;LUX
Madagascar;54390;5664;48726;2009;1;1;01/01/2009;MDG
Malawi;27195;2832;24363;2009;1;1;01/01/2009;MWI
Malaysia;5167068;538067;4629001;2009;1;1;01/01/2009;MYS
Maldives;27195;2832;24363;2009;1;1;01/01/2009;MDV
Mali;27195;2832;24363;2009;1;1;01/01/2009;MLI
Malta;462317;48143;414174;2009;1;1;01/01/2009;MLT
Marshall Islands;27195;2832;24363;2009;1;1;01/01/2009;MHL
Mauritania;27195;2832;24363;2009;1;1;01/01/2009;MRT
Mauritius;299146;31151;267995;2009;1;1;01/01/2009;MUS
Mexico;61379331;6391675;54987656;2009;1;1;01/01/2009;MEX
Micronesia (Federated States of);27195;2832;24363;2009;1;1;01/01/2009;FSM
Moldova;27195;2832;24363;2009;1;1;01/01/2009;MDA
Monaco;81585;8496;73089;2009;1;1;01/01/2009;MCO
Mongolia;27195;2832;24363;2009;1;1;01/01/2009;MNG
Montenegro;27195;2832;24363;2009;1;1;01/01/2009;MNE
Morocco;1142194;118941;1023253;2009;1;1;01/01/2009;MAR
Mozambique;27195;2832;24363;2009;1;1;01/01/2009;MOZ
Myanmar;135976;14160;121816;2009;1;1;01/01/2009;MMR
Namibia;163171;16992;146179;2009;1;1;01/01/2009;NAM
Nauru;27195;2832;24363;2009;1;1;01/01/2009;NRU
Nepal;81585;8496;73089;2009;1;1;01/01/2009;NPL
Netherlands;50936414;5304212;45632202;2009;1;1;01/01/2009;NLD
New Zealand;6961944;724975;6236969;2009;1;1;01/01/2009;NZL
Nicaragua;54390;5664;48726;2009;1;1;01/01/2009;NIC
Niger;27195;2832;24363;2009;1;1;01/01/2009;NER
Nigeria;1305365;135933;1169432;2009;1;1;01/01/2009;NGA
Norway;21266565;2214572;19051993;2009;1;1;01/01/2009;NOR
Oman;1985242;206731;1778511;2009;1;1;01/01/2009;OMN
Pakistan;1604511;167084;1437427;2009;1;1;01/01/2009;PAK
Palau;27195;2832;24363;2009;1;1;01/01/2009;PLW
Panama;625487;65134;560353;2009;1;1;01/01/2009;PAN
Papua New Guinea;54390;5664;48726;2009;1;1;01/01/2009;PNG
Paraguay;135976;14160;121816;2009;1;1;01/01/2009;PRY
Peru;2121218;220891;1900327;2009;1;1;01/01/2009;PER
Philippines;2121218;220891;1900327;2009;1;1;01/01/2009;PHL
Poland;13624743;1418799;12205944;2009;1;1;01/01/2009;POL
Portugal;14331815;1492429;12839386;2009;1;1;01/01/2009;PRT
Qatar;2311583;240714;2070869;2009;1;1;01/01/2009;QAT
Republic of Korea;59094943;6153793;52941150;2009;1;1;01/01/2009;KOR
Romania;1903657;198235;1705422;2009;1;1;01/01/2009;ROM
Russian Federation;32634115;3398321;29235794;2009;1;1;01/01/2009;RUS
Rwanda;27195;2832;24363;2009;1;1;01/01/2009;RWA
Saint Kitts and Nevis;27195;2832;24363;2009;1;1;01/01/2009;KN1
Saint Lucia;27195;2832;24363;2009;1;1;01/01/2009;LCA
Saint Vincent and the Grenadines;27195;2832;24363;2009;1;1;01/01/2009;VCT
Samoa;27195;2832;24363;2009;1;1;01/01/2009;WSM
San Marino;81585;8496;73089;2009;1;1;01/01/2009;SMR
Sao Tome and Principe;27195;2832;24363;2009;1;1;01/01/2009;STP
Saudi Arabia;20341931;2118286;18223645;2009;1;1;01/01/2009;SAU
Senegal;108780;11327;97453;2009;1;1;01/01/2009;SEN
Serbia;571097;59471;511626;2009;1;1;01/01/2009;SER
Seychelles;54390;5664;48726;2009;1;1;01/01/2009;SYC
Sierra Leone;27195;2832;24363;2009;1;1;01/01/2009;SLE
Singapore;9436698;982681;8454017;2009;1;1;01/01/2009;SGP
Slovakia;1713291;178412;1534879;2009;1;1;01/01/2009;SVK
Slovenia;2610729;271865;2338864;2009;1;1;01/01/2009;SVN
Solomon Islands;27195;2832;24363;2009;1;1;01/01/2009;SLB
Somalia;27195;2832;24363;2009;1;1;01/01/2009;SOM
South Africa;7886578;821261;7065317;2009;1;1;01/01/2009;ZAF
Spain;80715043;8405180;72309863;2009;1;1;01/01/2009;ESP
Sri Lanka;435122;45311;389811;2009;1;1;01/01/2009;LKA
Sudan;271951;28319;243632;2009;1;1;01/01/2009;SDN
Suriname;27195;2832;24363;2009;1;1;01/01/2009;SUR
Swaziland;54390;5664;48726;2009;1;1;01/01/2009;SWZ
Sweden;29125947;3033001;26092946;2009;1;1;01/01/2009;SWE
Switzerland;33069236;3443632;29625604;2009;1;1;01/01/2009;CHE
Syrian Arab Republic;435122;45311;389811;2009;1;1;01/01/2009;SYR
Tajikistan;27195;2832;24363;2009;1;1;01/01/2009;TJK
Thailand;5058288;526740;4531548;2009;1;1;01/01/2009;THA
North Macedonia;135976;14160;121816;2009;1;1;01/01/2009;MKD
Timor-Leste;27195;2832;24363;2009;1;1;01/01/2009;TMP
Togo;27195;2832;24363;2009;1;1;01/01/2009;TGO
Tonga;27195;2832;24363;2009;1;1;01/01/2009;TON
Trinidad and Tobago;734268;76462;657806;2009;1;1;01/01/2009;TTO
Tunisia;843048;87790;755258;2009;1;1;01/01/2009;TUN
Turkey;10361331;1078967;9282364;2009;1;1;01/01/2009;TUR
Turkmenistan;163171;16992;146179;2009;1;1;01/01/2009;TKM
Tuvalu;27195;2832;24363;2009;1;1;01/01/2009;TUV
Uganda;81585;8496;73089;2009;1;1;01/01/2009;UGA
Ukraine;1223779;127437;1096342;2009;1;1;01/01/2009;UKR
United Arab Emirates;8212919;855244;7357675;2009;1;1;01/01/2009;ARE
United Kingdom of Great Britain and  Northern Ireland;180629824;18809705;161820119;2009;1;1;01/01/2009;GBR
United Republic of Tanzania;163171;16992;146179;2009;1;1;01/01/2009;TZA
United States of America;598292101;0a;598292101;2009;1;1;01/01/2009;USA
Uruguay;734268;76462;657806;2009;1;1;01/01/2009;URY
Uzbekistan;217561;22655;194906;2009;1;1;01/01/2009;UZB
Vanuatu;27195;2832;24363;2009;1;1;01/01/2009;VUT
Venezuela;5439019;566387;4872632;2009;1;1;01/01/2009;VEN
Viet Nam;652682;67966;584716;2009;1;1;01/01/2009;VNM
Yemen;190366;19824;170542;2009;1;1;01/01/2009;YEM
Zambia;27195;2832;24363;2009;1;1;01/01/2009;ZMB
Zimbabwe;217561;22655;194906;2009;1;1;01/01/2009;ZWE
Indonesia;3317613;372896;2944717;2008;1;1;01/01/2008;IDN
Afghanistan;20606;2316;18290;2008;1;1;01/01/2008;AFG
Albania;123638;13897;109741;2008;1;1;01/01/2008;ALB
Algeria;1751535;196871;1554664;2008;1;1;01/01/2008;DZA
Andorra;164850;18529;146321;2008;1;1;01/01/2008;AND
Angola;61819;6948;54871;2008;1;1;01/01/2008;AGO
Antigua and Barbuda;41213;4632;36581;2008;1;1;01/01/2008;ATG
Argentina;6697044;752741;5944303;2008;1;1;01/01/2008;ARG
Armenia;41213;4632;36581;2008;1;1;01/01/2008;ARM
Australia;36823441;4138917;32684524;2008;1;1;01/01/2008;AUS
Austria;18277780;2054404;16223376;2008;1;1;01/01/2008;AUT
Azerbaijan;103032;11581;91451;2008;1;1;01/01/2008;AZE
Bahamas;329701;37058;292643;2008;1;1;01/01/2008;BHS
Bahrain;680008;76432;603576;2008;1;1;01/01/2008;BHR
Bangladesh;206063;23161;182902;2008;1;1;01/01/2008;BGD
Barbados;185457;20845;164612;2008;1;1;01/01/2008;BRB
Belarus;412126;46323;365803;2008;1;1;01/01/2008;BLR
Belgium;22708132;2552371;20155761;2008;1;1;01/01/2008;BEL
Belize;20606;2316;18290;2008;1;1;01/01/2008;BLZ
Benin;20606;2316;18290;2008;1;1;01/01/2008;BEN
Bhutan;20606;2316;18290;2008;1;1;01/01/2008;BTN
Bolivia;123638;13897;109741;2008;1;1;01/01/2008;BOL
Bosnia and Herzegovina;123638;13897;109741;2008;1;1;01/01/2008;BIH
Botswana;288488;32426;256062;2008;1;1;01/01/2008;BWA
Brazil;18051111;2028926;16022185;2008;1;1;01/01/2008;BRA
Brunei Darussalam;535764;60219;475545;2008;1;1;01/01/2008;BRN
Bulgaria;412126;46323;365803;2008;1;1;01/01/2008;BGR
Burkina Faso;41213;4632;36581;2008;1;1;01/01/2008;BFA
Burundi;20606;2316;18290;2008;1;1;01/01/2008;BDI
Cambodia;20606;2316;18290;2008;1;1;01/01/2008;KHM
Cameroon;185457;20845;164612;2008;1;1;01/01/2008;CMR
Canada;61344927;6895107;54449820;2008;1;1;01/01/2008;CAN
Cape Verde;20606;2316;18290;2008;1;1;01/01/2008;CPV
Central African Republic;20606;2316;18290;2008;1;1;01/01/2008;CAF
Chad;20606;2316;18290;2008;1;1;01/01/2008;TCD
Chile;3317613;372896;2944717;2008;1;1;01/01/2008;CHL
China;54956977;6177108;48779869;2008;1;1;01/01/2008;CHN
Colombia;2163661;243193;1920468;2008;1;1;01/01/2008;COL
Comoros;20606;2316;18290;2008;1;1;01/01/2008;COM
Congo;20606;2316;18290;2008;1;1;01/01/2008;COG
Costa Rica;659401;74116;585285;2008;1;1;01/01/2008;CRI
Côte d’Ivoire;185457;20845;164612;2008;1;1;01/01/2008;CIV
Croatia;1030315;115806;914509;2008;1;1;01/01/2008;HRV
Cuba;1112740;125071;987669;2008;1;1;01/01/2008;CUB
Cyprus;906677;101910;804767;2008;1;1;01/01/2008;CYP
Czech Republic;5790368;650832;5139536;2008;1;1;01/01/2008;CZE
Democratic People’s Republic of Korea;144244;16213;128031;2008;1;1;01/01/2008;PRK
Democratic Republic of the Congo;61819;6948;54871;2008;1;1;01/01/2008;ZAR
Denmark;15228049;1711617;13516432;2008;1;1;01/01/2008;DNK
Djibouti;20606;2316;18290;2008;1;1;01/01/2008;DJI
Dominica;20606;2316;18290;2008;1;1;01/01/2008;DMA
Dominican Republic;494551;55587;438964;2008;1;1;01/01/2008;DOM
Ecuador;432732;48639;384093;2008;1;1;01/01/2008;ECU
Egypt;1813354;203819;1609535;2008;1;1;01/01/2008;EGY
El Salvador;412126;46323;365803;2008;1;1;01/01/2008;SLV
Equatorial Guinea;41213;4632;36 581;2008;1;1;01/01/2008;GNQ
Eritrea;20606;1 070a;19536;2008;1;1;01/01/2008;ERI
Estonia;329701;37058;292643;2008;1;1;01/01/2008;EST
Ethiopia;61819;6948;54871;2008;1;1;01/01/2008;ETH
Fiji;61819;6948;54871;2008;1;1;01/01/2008;FJI
Finland;11621948;1306295;10315653;2008;1;1;01/01/2008;FIN
France;129840236;14593910;115246326;2008;1;1;01/01/2008;FRA
Gabon;164850;18529;146321;2008;1;1;01/01/2008;GAB
Gambia;20606;2316;18290;2008;1;1;01/01/2008;GMB
Georgia;61819;6948;54871;2008;1;1;01/01/2008;GEO
Germany;176740154;19865413;156874741;2008;1;1;01/01/2008;DEU
Ghana;82425;9265;73160;2008;1;1;01/01/2008;GHA
Greece;12281349;1380411;10900938;2008;1;1;01/01/2008;GRC
Grenada;20606;2316;18290;2008;1;1;01/01/2008;GRD
Guatemala;659401;74116;585285;2008;1;1;01/01/2008;GTM
Guinea;20606;2316;18290;2008;1;1;01/01/2008;GIN
Guinea-Bissau;20606;2316;18290;2008;1;1;01/01/2008;GNB
Guyana;20606;2316;18290;2008;1;1;01/01/2008;GUY
Haiti;41213;4632;36581;2008;1;1;01/01/2008;HTI
Honduras;103032;11581;91451;2008;1;1;01/01/2008;HND
Hungary;5027935;565135;4462800;2008;1;1;01/01/2008;HUN
Iceland;762433;85697;676736;2008;1;1;01/01/2008;ISL
India;9272831;1042257;8230574;2008;1;1;01/01/2008;IND
Iran (Islamic Republic of);3709132;416903;3292229;2008;1;1;01/01/2008;IRN
Iraq;309094;34742;274352;2008;1;1;01/01/2008;IRQ
Ireland;9169799;1030676;8139123;2008;1;1;01/01/2008;IRL
Israel;8634036;970457;7663579;2008;1;1;01/01/2008;ISR
Italy;104659349;11763604;92895745;2008;1;1;01/01/2008;ITA
Jamaica;206063;23161;182902;2008;1;1;01/01/2008;JAM
Japan;342558973;38503279;304055694;2008;1;1;01/01/2008;JPN
Jordan;247276;27794;219482;2008;1;1;01/01/2008;JOR
Kazakhstan;597582;67168;530414;2008;1;1;01/01/2008;KAZ
Kenya;206063;23161;182902;2008;1;1;01/01/2008;KEN
Kiribati;20606;2316;18290;2008;1;1;01/01/2008;KIR
Kuwait;3750345;421535;3328810;2008;1;1;01/01/2008;KWT
Kyrgyzstan;20606;2316;18290;2008;1;1;01/01/2008;KGZ
Lao People’s Democratic Republic;20606;2316;18290;2008;1;1;01/01/2008;LAO
Latvia;370913;41690;329223;2008;1;1;01/01/2008;LVA
Lebanon;700614;78748;621866;2008;1;1;01/01/2008;LBN
Lesotho;20606;2316;18290;2008;1;1;01/01/2008;LSO
Liberia;20606;2316;18290;2008;1;1;01/01/2008;LBR
Libya;1277590;143600;1133990;2008;1;1;01/01/2008;LBY
Liechtenstein;206063;23161;182902;2008;1;1;01/01/2008;LIE
Lithuania;638795;71800;566995;2008;1;1;01/01/2008;LTU
Luxembourg;1751535;196871;1554664;2008;1;1;01/01/2008;LUX
Madagascar;41213;4632;36581;2008;1;1;01/01/2008;MDG
Malawi;20606;2316;18290;2008;1;1;01/01/2008;MWI
Malaysia;3915195;440064;3475131;2008;1;1;01/01/2008;MYS
Maldives;20606;2316;18290;2008;1;1;01/01/2008;MDV
Mali;20606;2316;18290;2008;1;1;01/01/2008;MLI
Malta;350307;39374;310933;2008;1;1;01/01/2008;MLT
Marshall Islands;20606;2316;18290;2008;1;1;01/01/2008;MHL
Mauritania;20606;2316;18290;2008;1;1;01/01/2008;MRT
Mauritius;226669;25478;201191;2008;1;1;01/01/2008;MUS
Mexico;46508398;5227497;41280901;2008;1;1;01/01/2008;MEX
Micronesia (Federated States of);20606;2316;18290;2008;1;1;01/01/2008;FSM
Moldova;20606;2316;18290;2008;1;1;01/01/2008;MDA
Monaco;61819;6948;54871;2008;1;1;01/01/2008;MCO
Mongolia;20606;2316;18290;2008;1;1;01/01/2008;MNG
Montenegro;20606;2316;18290;2008;1;1;01/01/2008;MNE
Morocco;865464;97277;768187;2008;1;1;01/01/2008;MAR
Mozambique;20606;2316;18290;2008;1;1;01/01/2008;MOZ
Myanmar;103032;11581;91451;2008;1;1;01/01/2008;MMR
Namibia;123638;13897;109741;2008;1;1;01/01/2008;NAM
Nauru;20606;2316;18290;2008;1;1;01/01/2008;NRU
Nepal;61819;6948;54871;2008;1;1;01/01/2008;NPL
Netherlands;38595582;4338104;34257478;2008;1;1;01/01/2008;NLD
New Zealand;5275210;592928;4682 282;2008;1;1;01/01/2008;NZL
Nicaragua;41213;4632;36581;2008;1;1;01/01/2008;NIC
Niger;20606;2316;18290;2008;1;1;01/01/2008;NER
Nigeria;989102;111174;877928;2008;1;1;01/01/2008;NGA
Norway;16114119;1811211;14302908;2008;1;1;01/01/2008;NOR
Oman;1504259;169077;1335182;2008;1;1;01/01/2008;OMN
Pakistan;1215771;136652;1079119;2008;1;1;01/01/2008;PAK
Palau;20606;2316;18290;2008;1;1;01/01/2008;PLW
Panama;473945;53271;420674;2008;1;1;01/01/2008;PAN
Papua New Guinea;41213;4632;36581;2008;1;1;01/01/2008;PNG
Paraguay;103032;11581;91451;2008;1;1;01/01/2008;PRY
Peru;1607291;180658;1426633;2008;1;1;01/01/2008;PER
Philippines;1607291;180658;1426633;2008;1;1;01/01/2008;PHL
Poland;10323752;1160379;9163373;2008;1;1;01/01/2008;POL
Portugal;10859515;1220599;9638916;2008;1;1;01/01/2008;PRT
Qatar;1751535;196871;1554664;2008;1;1;01/01/2008;QAT
Republic of Korea;44777469;5032942;39744527;2008;1;1;01/01/2008;KOR
Romania;1442440;162129;1280311;2008;1;1;01/01/2008;ROM
Russian Federation;24727549;2779351;21948198;2008;1;1;01/01/2008;RUS
Rwanda;20606;2316;18290;2008;1;1;01/01/2008;RWA
Saint Kitts and Nevis;20606;2316;18290;2008;1;1;01/01/2008;KN1
Saint Lucia;20606;2316;18290;2008;1;1;01/01/2008;LCA
Saint Vincent and the Grenadines;20606;2316;18290;2008;1;1;01/01/2008;VCT
Samoa;20606;2316;18290;2008;1;1;01/01/2008;WSM
San Marino;61819;6948;54871;2008;1;1;01/01/2008;SMR
Sao Tome and Principe;20606;2316;18290;2008;1;1;01/01/2008;STP
Saudi Arabia;15413505;1732462;13681043;2008;1;1;01/01/2008;SAU
Senegal;82425;9265;73160;2008;1;1;01/01/2008;SEN
Serbia;432732;48639;384093;2008;1;1;01/01/2008;SER
Seychelles;41213;4632;36581;2008;1;1;01/01/2008;SYC
Sierra Leone;20606;2316;18290;2008;1;1;01/01/2008;SLE
Singapore;7150383;803696;6346687;2008;1;1;01/01/2008;SGP
Slovakia;1298196;145916;1152280;2008;1;1;01/01/2008;SVK
Slovenia;1978204;222348;1755856;2008;1;1;01/01/2008;SVN
Solomon Islands;20606;2316;18290;2008;1;1;01/01/2008;SLB
Somalia;20606;2316;18290;2008;1;1;01/01/2008;SOM
South Africa;5975824;671677;5304147;2008;1;1;01/01/2008;ZAF
Spain;61159470;6874262;54285208;2008;1;1;01/01/2008;ESP
Sri Lanka;329701;37058;292643;2008;1;1;01/01/2008;LKA
Sudan;206063;23161;182902;2008;1;1;01/01/2008;SDN
Suriname;20606;2316;18290;2008;1;1;01/01/2008;SUR
Swaziland;41213;4632;36581;2008;1;1;01/01/2008;SWZ
Sweden;22069337;2480571;19588766;2008;1;1;01/01/2008;SWE
Switzerland;25057249;2816409;22240840;2008;1;1;01/01/2008;CHE
Syrian Arab Republic;329701;37058;292643;2008;1;1;01/01/2008;SYR
Tajikistan;20606;2316;18290;2008;1;1;01/01/2008;TJK
Thailand;3832770;430800;3401970;2008;1;1;01/01/2008;THA
North Macedonia;103032;11581;91451;2008;1;1;01/01/2008;MKD
Timor-Leste;20606;2316;18290;2008;1;1;01/01/2008;TMP
Togo;20606;2316;18290;2008;1;1;01/01/2008;TGO
Tonga;20606;2316;18 290;2008;1;1;01/01/2008;TON
Trinidad and Tobago;556370;62536;493834;2008;1;1;01/01/2008;TTO
Tunisia;638795;71800;566995;2008;1;1;01/01/2008;TUN
Turkey;7850997;882444;6968553;2008;1;1;01/01/2008;TUR
Turkmenistan;123638;13897;109741;2008;1;1;01/01/2008;TKM
Tuvalu;20606;2316;18290;2008;1;1;01/01/2008;TUV
Uganda;61819;6948;54871;2008;1;1;01/01/2008;UGA
Ukraine;927283;104226;823057;2008;1;1;01/01/2008;UKR
United Arab Emirates;6223100;699470;5523630;2008;1;1;01/01/2008;ARE
United Kingdom of Great Britain and  Northern Ireland;136866982;15383709;121483273;2008;1;1;01/01/2008;GBR
United Republic of Tanzania;123638;13897;109741;2008;1;1;01/01/2008;TZA
United States of America;453338391;—a;453338391;2008;1;1;01/01/2008;USA
Uruguay;556370;62536;493834;2008;1;1;01/01/2008;URY
Uzbekistan;164850;18529;146321;2008;1;1;01/01/2008;UZB
Vanuatu;20606;2316;18290;2008;1;1;01/01/2008;VUT
Venezuela;4121258;463225;3658033;2008;1;1;01/01/2008;VEN
Viet Nam;494551;55587;438964;2008;1;1;01/01/2008;VNM
Yemen;144244;16213;128031;2008;1;1;01/01/2008;YEM
Zambia;20606;2316;18290;2008;1;1;01/01/2008;ZMB
Zimbabwe;164850;18529;146321;2008;1;1;01/01/2008;ZWE
Indonesia;3609085;387870;3221215;2007;1;1;01/01/2007;IDN
Afghanistan;22417;2409;20008;2007;1;1;01/01/2007;AFG
Albania;134500;14455;120045;2007;1;1;01/01/2007;ALB
Algeria;1905417;204776;1700641;2007;1;1;01/01/2007;DZA
Andorra;179333;19273;160060;2007;1;1;01/01/2007;AND
Angola;67250;7227;60023;2007;1;1;01/01/2007;AGO
Antigua and Barbuda;44833;4818;40015;2007;1;1;01/01/2007;ATG
Argentina;7285419;782966;6502453;2007;1;1;01/01/2007;ARG
Armenia;44833;4818;40015;2007;1;1;01/01/2007;ARM
Australia;40058597;4305110;35753487;2007;1;1;01/01/2007;AUS
Austria;19883590;2136896;17746694;2007;1;1;01/01/2007;AUT
Azerbaijan;112083;12046;100037;2007;1;1;01/01/2007;AZE
Bahamas;358667;38546;320121;2007;1;1;01/01/2007;BHS
Bahrain;739750;79501;660249;2007;1;1;01/01/2007;BHR
Bangladesh;224167;24091;200076;2007;1;1;01/01/2007;BGD
Barbados;201750;21682;180068;2007;1;1;01/01/2007;BRB
Belarus;448333;48183;400150;2007;1;1;01/01/2007;BLR
Belgium;24703175;2654858;22048317;2007;1;1;01/01/2007;BEL
Belize;22417;2409;20008;2007;1;1;01/01/2007;BLZ
Benin;22417;2409;20008;2007;1;1;01/01/2007;BEN
Bhutan;22417;2409;20008;2007;1;1;01/01/2007;BTN
Bolivia;134500;14455;120045;2007;1;1;01/01/2007;BOL
Bosnia and Herzegovina;134500;14455;120045;2007;1;1;01/01/2007;BIH
Botswana;313833;33728;280105;2007;1;1;01/01/2007;BWA
Brazil;19637007;2110395;17526612;2007;1;1;01/01/2007;BRA
Brunei Darussalam;582833;62637;520196;2007;1;1;01/01/2007;BRN
Bulgaria;448333;48183;400150;2007;1;1;01/01/2007;BGR
Burkina Faso;44833;4818;40015;2007;1;1;01/01/2007;BFA
Burundi;22417;2409;20008;2007;1;1;01/01/2007;BDI
Cambodia;22417;2409;20008;2007;1;1;01/01/2007;KHM
Cameroon;201750;21682;180068;2007;1;1;01/01/2007;CMR
Canada;66734440;7171971;59562469;2007;1;1;01/01/2007;CAN
Cape Verde;22417;2409;20008;2007;1;1;01/01/2007;CPV
Central African Republic;22417;2409;20008;2007;1;1;01/01/2007;CAF
Chad;22417;2409;20008;2007;1;1;01/01/2007;TCD
Chile;3609085;387870;3221215;2007;1;1;01/01/2007;CHL
China;59785271;6425142;53360129;2007;1;1;01/01/2007;CHN
Colombia;2353751;252958;2100793;2007;1;1;01/01/2007;COL
Comoros;22417;2409;20008;2007;1;1;01/01/2007;COM
Congo;22417;2409;20008;2007;1;1;01/01/2007;COG
Costa Rica;717333;77092;640241;2007;1;1;01/01/2007;CRI
Côte d’Ivoire;201750;21682;180068;2007;1;1;01/01/2007;CIV
Croatia;1120834;120456;1000378;2007;1;1;01/01/2007;HRV
Cuba;1210500;130093;1080407;2007;1;1;01/01/2007;CUB
Cyprus;986334;106002;880332;2007;1;1;01/01/2007;CYP
Czech Republic;6299085;676965;5622120;2007;1;1;01/01/2007;CZE
Democratic People’s Republic of Korea;156917;16864;140053;2007;1;1;01/01/2007;PRK
Democratic Republic of the Congo;67250;7227;60023;2007;1;1;01/01/2007;ZAR
Denmark;16565922;1780345;14785577;2007;1;1;01/01/2007;DNK
Djibouti;22417;2409;20008;2007;1;1;01/01/2007;DJI
Dominica;22417;2409;20008;2007;1;1;01/01/2007;DMA
Dominican Republic;538000;57819;480181;2007;1;1;01/01/2007;DOM
Ecuador;470750;50592;420158;2007;1;1;01/01/2007;ECU
Egypt;1972667;212003;1760664;2007;1;1;01/01/2007;EGY
El Salvador;448333;48183;400150;2007;1;1;01/01/2007;SLV
Equatorial Guinea;44833;4818;40015;2007;1;1;01/01/2007;GNQ
Eritrea;22417;(13 112)a;35529;2007;1;1;01/01/2007;ERI
Estonia;358667;38546;320121;2007;1;1;01/01/2007;EST
Ethiopia;67250;7227;60023;2007;1;1;01/01/2007;ETH
Fiji;67250;7227;60023;2007;1;1;01/01/2007;FJI
Finland;12643004;1358748;11284256;2007;1;1;01/01/2007;FIN
France;141247466;15179909;126067557;2007;1;1;01/01/2007;FRA
Gabon;179333;19273;160060;2007;1;1;01/01/2007;GAB
Gambia;22417;2409;20008;2007;1;1;01/01/2007;GMB
Georgia;67250;7227;60023;2007;1;1;01/01/2007;GEO
Germany;192267817;20663082;171604735;2007;1;1;01/01/2007;DEU
Ghana;89667;9637;80030;2007;1;1;01/01/2007;GHA
Greece;13360338;1435840;11924498;2007;1;1;01/01/2007;GRC
Grenada;22417;2409;20008;2007;1;1;01/01/2007;GRD
Guatemala;717333;77092;640241;2007;1;1;01/01/2007;GTM
Guinea;22417;2409;20008;2007;1;1;01/01/2007;GIN
Guinea-Bissau;22417;2409;20008;2007;1;1;01/01/2007;GNB
Guyana;22417;2409;20008;2007;1;1;01/01/2007;GUY
Haiti;44833;4818;40015;2007;1;1;01/01/2007;HTI
Honduras;112083;12046;100037;2007;1;1;01/01/2007;HND
Hungary;5469668;587827;4881841;2007;1;1;01/01/2007;HUN
Iceland;829417;89138;740279;2007;1;1;01/01/2007;ISL
India;10087503;1084107;9003396;2007;1;1;01/01/2007;IND
Iran (Islamic Republic of);4035001;433643;3601358;2007;1;1;01/01/2007;IRN
Iraq;336250;36137;300113;2007;1;1;01/01/2007;IRQ
Ireland;9975420;1072062;8903358;2007;1;1;01/01/2007;IRL
Israel;9392587;1009424;8383163;2007;1;1;01/01/2007;ISR
Italy;113854290;12235956;101618334;2007;1;1;01/01/2007;ITA
Jamaica;224167;24091;200076;2007;1;1;01/01/2007;JAM
Japan;372654797;40049327;332605470;2007;1;1;01/01/2007;JPN
Jordan;269000;28910;240090;2007;1;1;01/01/2007;JOR
Kazakhstan;650083;69865;580218;2007;1;1;01/01/2007;KAZ
Kenya;224167;24091;200076;2007;1;1;01/01/2007;KEN
Kiribati;22417;2409;20008;2007;1;1;01/01/2007;KIR
Kuwait;4079835;438461;3641374;2007;1;1;01/01/2007;KWT
Kyrgyzstan;22417;2409;20008;2007;1;1;01/01/2007;KGZ
Lao People’s Democratic Republic;22417;2409;20008;2007;1;1;01/01/2007;LAO
Latvia;403500;43364;360136;2007;1;1;01/01/2007;LVA
Lebanon;762167;81910;680257;2007;1;1;01/01/2007;LBN
Lesotho;22417;2409;20008;2007;1;1;01/01/2007;LSO
Liberia;22417;2409;20008;2007;1;1;01/01/2007;LBR
Libya;1389834;149366;1240468;2007;1;1;01/01/2007;LBY
Liechtenstein;224167;24091;200076;2007;1;1;01/01/2007;LIE
Lithuania;694917;74683;620234;2007;1;1;01/01/2007;LTU
Luxembourg;1905417;204776;1700641;2007;1;1;01/01/2007;LUX
Madagascar;44833;4818;40015;2007;1;1;01/01/2007;MDG
Malawi;22417;2409;20008;2007;1;1;01/01/2007;MWI
Malaysia;4259168;457734;3801434;2007;1;1;01/01/2007;MYS
Maldives;22417;2409;20008;2007;1;1;01/01/2007;MDV
Mali;22417;2409;20008;2007;1;1;01/01/2007;MLI
Malta;381083;40955;340128;2007;1;1;01/01/2007;MLT
Marshall Islands;22417;2409;20008;2007;1;1;01/01/2007;MHL
Mauritania;22417;2409;20008;2007;1;1;01/01/2007;MRT
Mauritius;246583;26501;220082;2007;1;1;01/01/2007;MUS
Mexico;50594434;5437400;45157034;2007;1;1;01/01/2007;MEX
Micronesia (Federated States of);22417;2409;20008;2007;1;1;01/01/2007;FSM
Moldova;22417;2409;20008;2007;1;1;01/01/2007;MDA
Monaco;67250;7227;60023;2007;1;1;01/01/2007;MCO
Mongolia;22417;2409;20008;2007;1;1;01/01/2007;MNG
Montenegro;22417;2409;20008;2007;1;1;01/01/2007;MNE
Morocco;941500;101183;840317;2007;1;1;01/01/2007;MAR
Mozambique;22417;2409;20008;2007;1;1;01/01/2007;MOZ
Myanmar;112083;12046;100037;2007;1;1;01/01/2007;MMR
Namibia;134500;14455;120045;2007;1;1;01/01/2007;NAM
Nauru;22417;2409;20008;2007;1;1;01/01/2007;NRU
Nepal;67250;7227;60023;2007;1;1;01/01/2007;NPL
Netherlands;41986431;4512295;37474136;2007;1;1;01/01/2007;NLD
New Zealand;5738669;616737;5121932;2007;1;1;01/01/2007;NZL
Nicaragua;44833;4818;40015;2007;1;1;01/01/2007;NIC
Niger;22417;2409;20008;2007;1;1;01/01/2007;NER
Nigeria;1076000;115638;960362;2007;1;1;01/01/2007;NGA
Norway;17529839;1883937;15645902;2007;1;1;01/01/2007;NOR
Oman;1636417;175866;1460551;2007;1;1;01/01/2007;OMN
Pakistan;1322584;142139;1180445;2007;1;1;01/01/2007;PAK
Palau;22417;2409;20008;2007;1;1;01/01/2007;PLW
Panama;515583;55410;460173;2007;1;1;01/01/2007;PAN
Papua New Guinea;44833;4818;40015;2007;1;1;01/01/2007;PNG
Paraguay;112083;12046;100037;2007;1;1;01/01/2007;PRY
Peru;1748501;187912;1560589;2007;1;1;01/01/2007;PER
Philippines;1748501;187912;1560589;2007;1;1;01/01/2007;PHL
Poland;11230754;1206973;10023781;2007;1;1;01/01/2007;POL
Portugal;11813587;1269610;10543977;2007;1;1;01/01/2007;PRT
Qatar;1905417;204776;1700641;2007;1;1;01/01/2007;QAT
Republic of Korea;48711434;5235033;43476401;2007;1;1;01/01/2007;KOR
Romania;1569167;168639;1400528;2007;1;1;01/01/2007;ROM
Russian Federation;26900009;2890953;24009056;2007;1;1;01/01/2007;RUS
Rwanda;22417;2409;20008;2007;1;1;01/01/2007;RWA
Saint Kitts and Nevis;22417;2409;20008;2007;1;1;01/01/2007;KN1
Saint Lucia;22417;2409;20008;2007;1;1;01/01/2007;LCA
Saint Vincent and the Grenadines;22417;2409;20008;2007;1;1;01/01/2007;VCT
Samoa;22417;2409;20008;2007;1;1;01/01/2007;WSM
San Marino;67250;7227;60023;2007;1;1;01/01/2007;SMR
Sao Tome and Principe;22 417;2409;20008;2007;1;1;01/01/2007;STP
Saudi Arabia;16767672;1802027;14965645;2007;1;1;01/01/2007;SAU
Senegal;89667;9637;80030;2007;1;1;01/01/2007;SEN
Serbia;470750;50592;420158;2007;1;1;01/01/2007;SER
Seychelles;44833;4818;40015;2007;1;1;01/01/2007;SYC
Sierra Leone;22417;2409;20008;2007;1;1;01/01/2007;SLE
Singapore;7778586;835967;6942619;2007;1;1;01/01/2007;SGP
Slovakia;1412250;151775;1260475;2007;1;1;01/01/2007;SVK
Slovenia;2152001;231276;1920725;2007;1;1;01/01/2007;SVN
Solomon Islands;22417;2409;20008;2007;1;1;01/01/2007;SLB
Somalia;22417;2409;20008;2007;1;1;01/01/2007;SOM
South Africa;6500836;698647;5802189;2007;1;1;01/01/2007;ZAF
Spain;66532690;7150289;59382401;2007;1;1;01/01/2007;ESP
Sri Lanka;358667;38546;320121;2007;1;1;01/01/2007;LKA
Sudan;224167;24091;200076;2007;1;1;01/01/2007;SDN
Suriname;22417;2409;20008;2007;1;1;01/01/2007;SUR
Swaziland;44833;4818;40015;2007;1;1;01/01/2007;SWZ
Sweden;24008258;2580175;21428083;2007;1;1;01/01/2007;SWE
Switzerland;27258676;2929499;24329177;2007;1;1;01/01/2007;CHE
Syrian Arab Republic;358667;38546;320121;2007;1;1;01/01/2007;SYR
Tajikistan;22417;2409;20008;2007;1;1;01/01/2007;TJK
Thailand;4169501;448098;3721403;2007;1;1;01/01/2007;THA
North Macedonia;112083;12046;100037;2007;1;1;01/01/2007;MKD
Timor-Leste;22417;2409;20008;2007;1;1;01/01/2007;TMP
Togo;22417;2409;20008;2007;1;1;01/01/2007;TGO
Tonga;22417;2409;20008;2007;1;1;01/01/2007;TON
Trinidad and Tobago;605250;65047;540203;2007;1;1;01/01/2007;TTO
Tunisia;694917;74683;620234;2007;1;1;01/01/2007;TUN
Turkey;8540753;861 007b;7679746;2007;1;1;01/01/2007;TUR
Turkmenistan;134500;14455;120045;2007;1;1;01/01/2007;TKM
Tuvalu;22417;2409;20008;2007;1;1;01/01/2007;TUV
Uganda;67250;7227;60023;2007;1;1;01/01/2007;UGA
Ukraine;1008750;108411;900339;2007;1;1;01/01/2007;UKR
United Arab Emirates;6769836;727556;6042280;2007;1;1;01/01/2007;ARE
United Kingdom of Great Britain and  Northern Ireland;148891552;16001422;132890130;2007;1;1;01/01/2007;GBR
United Republic of Tanzania;134500;14455;120045;2007;1;1;01/01/2007;TZA
United States of America;493166839;—b;493166839;2007;1;1;01/01/2007;USA
Uruguay;605250;65047;540203;2007;1;1;01/01/2007;URY
Uzbekistan;179333;19273;160060;2007;1;1;01/01/2007;UZB
Vanuatu;22417;2409;20008;2007;1;1;01/01/2007;VUT
Venezuela;4483335;481826;4001509;2007;1;1;01/01/2007;VEN
Viet Nam;538000;57819;480181;2007;1;1;01/01/2007;VNM
Yemen;156917;16864;140053;2007;1;1;01/01/2007;YEM
Zambia;22417;2409;20008;2007;1;1;01/01/2007;ZMB
Zimbabwe;179333;19273;160060;2007;1;1;01/01/2007;ZWE
Indonesia;2733273;309904;2423369;2006;1;1;01/01/2006;IDN
Afghanistan;38497;4365;34132;2006;1;1;01/01/2006;AFG
Albania;96242;10912;85330;2006;1;1;01/01/2006;ALB
Algeria;1462879;165864;1297015;2006;1;1;01/01/2006;DZA
Andorra;96242;10912;85330;2006;1;1;01/01/2006;AND
Angola;19248;2182;17066;2006;1;1;01/01/2006;AGO
Antigua and Barbuda;57745;6547;51198;2006;1;1;01/01/2006;ATG
Argentina;18401473;2086395;16315078;2006;1;1;01/01/2006;ARG
Armenia;38497;4365;34132;2006;1;1;01/01/2006;ARM
Australia;30643457;3474414;27169043;2006;1;1;01/01/2006;AUS
Austria;16534378;1874700;14659678;2006;1;1;01/01/2006;AUT
Azerbaijan;96242;10912;85330;2006;1;1;01/01/2006;AZE
Bahamas;250229;28372;221857;2006;1;1;01/01/2006;BHS
Bahrain;577452;65473;511979;2006;1;1;01/01/2006;BHR
Bangladesh;192484;21824;170660;2006;1;1;01/01/2006;BGD
Barbados;192484;21824;170660;2006;1;1;01/01/2006;BRB
Belarus;346471;39284;307187;2006;1;1;01/01/2006;BLR
Belgium;20576542;2333008;18243534;2006;1;1;01/01/2006;BEL
Belize;19248;2182;17066;2006;1;1;01/01/2006;BLZ
Benin;38497;4365;34132;2006;1;1;01/01/2006;BEN
Bhutan;19248;2182;17066;2006;1;1;01/01/2006;BTN
Bolivia;173236;19642;153594;2006;1;1;01/01/2006;BOL
Bosnia and Herzegovina;57745;6547;51198;2006;1;1;01/01/2006;BIH
Botswana;230981;26189;204792;2006;1;1;01/01/2006;BWA
Brazil;29315317;3323827;25991490;2006;1;1;01/01/2006;BRA
Brunei Darussalam;654446;74203;580243;2006;1;1;01/01/2006;BRN
Bulgaria;327223;37101;290122;2006;1;1;01/01/2006;BGR
Burkina Faso;38497;4365;34132;2006;1;1;01/01/2006;BFA
Burundi;19248;2182;17066;2006;1;1;01/01/2006;BDI
Cambodia;38497;4365;34132;2006;1;1;01/01/2006;KHM
Cameroon;153987;17460;136527;2006;1;1;01/01/2006;CMR
Canada;54145756;6139151;48006605;2006;1;1;01/01/2006;CAN
Cape Verde;19248;2182;17066;2006;1;1;01/01/2006;CPV
Central African Republic;19248;2182;17066;2006;1;1;01/01/2006;CAF
Chad;19248;2182;17066;2006;1;1;01/01/2006;TCD
Chile;4292394;486680;3805714;2006;1;1;01/01/2006;CHL
China;39516971;4480511;35036460;2006;1;1;01/01/2006;CHN
Colombia;2983503;338275;2645228;2006;1;1;01/01/2006;COL
Comoros;19248;2182;17066;2006;1;1;01/01/2006;COM
Congo;19248;2182;17066;2006;1;1;01/01/2006;COG
Costa Rica;577452;65473;511979;2006;1;1;01/01/2006;CRI
Côte d’Ivoire;192484;21824;170660;2006;1;1;01/01/2006;CIV
Croatia;712191;80750;631441;2006;1;1;01/01/2006;HRV
Cuba;827682;93844;733838;2006;1;1;01/01/2006;CUB
Cyprus;750688;85115;665573;2006;1;1;01/01/2006;CYP
Czech Republic;3522458;399383;3123075;2006;1;1;01/01/2006;CZE
Republic of Korea;192484;21824;170660;2006;1;1;01/01/2006;KOR
Democratic Republic of the Congo;57745;6547;51198;2006;1;1;01/01/2006;ZAR
Denmark;13820353;1566978;12253375;2006;1;1;01/01/2006;DNK
Djibouti;19248;2182;17066;2006;1;1;01/01/2006;DJI
Dominica;19248;2182;17066;2006;1;1;01/01/2006;DMA
Dominican Republic;673694;76385;597309;2006;1;1;01/01/2006;DOM
Ecuador;365720;41466;324254;2006;1;1;01/01/2006;ECU
Egypt;2309808;261891;2047917;2006;1;1;01/01/2006;EGY
El Salvador;423465;48013;375452;2006;1;1;01/01/2006;SLV
Equatorial Guinea;38497;4365;34132;2006;1;1;01/01/2006;GNQ
Eritrea;19248;(15547);34795;2006;1;1;01/01/2006;ERI
Estonia;230981;26189;204792;2006;1;1;01/01/2006;EST
Ethiopia;76994;8730;68264;2006;1;1;01/01/2006;ETH
Fiji;76994;8730;68264;2006;1;1;01/01/2006;FJI
Finland;10259399;1163231;9096168;2006;1;1;01/01/2006;FIN
France;116067867;13159999;102907868;2006;1;1;01/01/2006;FRA
Gabon;173236;19642;153594;2006;1;1;01/01/2006;GAB
Gambia;19248;2182;17066;2006;1;1;01/01/2006;GMB
Georgia;57745;6547;51198;2006;1;1;01/01/2006;GEO
Germany;166729663;18904131;147825532;2006;1;1;01/01/2006;DEU
Ghana;76994;8730;68264;2006;1;1;01/01/2006;GHA
Greece;10201654;1156683;9044971;2006;1;1;01/01/2006;GRC
Grenada;19248;2182;17066;2006;1;1;01/01/2006;GRD
Guatemala;577452;65473;511979;2006;1;1;01/01/2006;GTM
Guinea;57745;6547;51198;2006;1;1;01/01/2006;GIN
Guinea-Bissau;19248;2182;17066;2006;1;1;01/01/2006;GNB
Guyana;19248;2182;17066;2006;1;1;01/01/2006;GUY
Haiti;57745;6547;51198;2006;1;1;01/01/2006;HTI
Honduras;96242;10912;85330;2006;1;1;01/01/2006;HND
Hungary;2425299;274985;2150314;2006;1;1;01/01/2006;HUN
Iceland;654446;74203;580243;2006;1;1;01/01/2006;ISL
India;8103578;918799;7184779;2006;1;1;01/01/2006;IND
Iran (Islamic Republic of);3021999;342640;2679359;2006;1;1;01/01/2006;IRN
Iraq;307975;34919;273056;2006;1;1;01/01/2006;IRQ
Ireland;6736941;763848;5973093;2006;1;1;01/01/2006;IRL
Israel;8989004;1019191;7969813;2006;1;1;01/01/2006;ISR
Italy;94028446;10661127;83367319;2006;1;1;01/01/2006;ITA
Jamaica;153987;17460;136527;2006;1;1;01/01/2006;JAM
Japan;374727900;42487372;332240528;2006;1;1;01/01/2006;JPN
Jordan;211733;24007;187726;2006;1;1;01/01/2006;JOR
Kazakhstan;481210;54561;426649;2006;1;1;01/01/2006;KAZ
Kenya;173236;19642;153594;2006;1;1;01/01/2006;KEN
Kiribati;19248;2182;17066;2006;1;1;01/01/2006;KIR
Kuwait;3118241;353552;2764689;2006;1;1;01/01/2006;KWT
Kyrgyzstan;19248;2182;17066;2006;1;1;01/01/2006;KGZ
Lao People’s Democratic Republic;19248;2182;17066;2006;1;1;01/01/2006;LAO
Latvia;288726;32737;255989;2006;1;1;01/01/2006;LVA
Lebanon;461962;52378;409584;2006;1;1;01/01/2006;LBN
Lesotho;19248;2182;17066;2006;1;1;01/01/2006;LSO
Liberia;19248;2182;17066;2006;1;1;01/01/2006;LBR
Libya;2540789;288080;2252709;2006;1;1;01/01/2006;LBY
Liechtenstein;96242;10912;85330;2006;1;1;01/01/2006;LIE
Lithuania;461962;52378;409584;2006;1;1;01/01/2006;LTU
Luxembourg;1482127;168047;1314080;2006;1;1;01/01/2006;LUX
Madagascar;57745;6547;51198;2006;1;1;01/01/2006;MDG
Malawi;19248;2182;17066;2006;1;1;01/01/2006;MWI
Malaysia;3907426;443032;3464394;2006;1;1;01/01/2006;MYS
Maldives;19248;2182;17066;2006;1;1;01/01/2006;MDV
Mali;38497;4365;34132;2006;1;1;01/01/2006;MLI
Malta;269478;30554;238924;2006;1;1;01/01/2006;MLT
Marshall Islands;19248;2182;17066;2006;1;1;01/01/2006;MHL
Mauritania;19248;2182;17066;2006;1;1;01/01/2006;MRT
Mauritius;211733;24007;187726;2006;1;1;01/01/2006;MUS
Mexico;36244742;4109499;32135243;2006;1;1;01/01/2006;MEX
Micronesia (Federated States of);19248;2182;17066;2006;1;1;01/01/2006;FSM
Monaco;57745;6547;51198;2006;1;1;01/01/2006;MCO
Mongolia;19248;2182;17066;2006;1;1;01/01/2006;MNG
Morocco;904675;102574;802101;2006;1;1;01/01/2006;MAR
Mozambique;19248;2182;17066;2006;1;1;01/01/2006;MOZ
Myanmar;192484;21824;170660;2006;1;1;01/01/2006;MMR
Namibia;115491;13095;102396;2006;1;1;01/01/2006;NAM
Nauru;19248;2182;17066;2006;1;1;01/01/2006;NRU
Nepal;76994;8730;68264;2006;1;1;01/01/2006;NPL
Netherlands;32529800;3688292;28841508;2006;1;1;01/01/2006;NLD
New Zealand;4253897;482315;3771582;2006;1;1;01/01/2006;NZL
Nicaragua;19248;2182;17066;2006;1;1;01/01/2006;NIC
Niger;19248;2182;17066;2006;1;1;01/01/2006;NER
Nigeria;808433;91662;716771;2006;1;1;01/01/2006;NGA
Norway;13069665;1481864;11587801;2006;1;1;01/01/2006;NOR
Oman;1347388;152770;1194618;2006;1;1;01/01/2006;OMN
Pakistan;1058662;120033;938629;2006;1;1;01/01/2006;PAK
Palau;19248;2182;17066;2006;1;1;01/01/2006;PLW
Panama;365720;41466;324254;2006;1;1;01/01/2006;PAN
Papua New Guinea;57745;6547;51198;2006;1;1;01/01/2006;PNG
Paraguay;230981;26189;204792;2006;1;1;01/01/2006;PRY
Peru;1770853;200783;1570070;2006;1;1;01/01/2006;PER
Philippines;1828598;207330;1621268;2006;1;1;01/01/2006;PHL
Poland;8873514;1006096;7867418;2006;1;1;01/01/2006;POL
Portugal;9046749;1025738;8021011;2006;1;1;01/01/2006;PRT
Qatar;1231898;139675;1092223;2006;1;1;01/01/2006;QAT
Republic of Korea;34570131;3919628;30650503;2006;1;1;01/01/2006;KOR
Moldova;19248;2182;17066;2006;1;1;01/01/2006;MDA
Romania;1154904;130945;1023959;2006;1;1;01/01/2006;ROM
Russian Federation;21173243;2400663;18772580;2006;1;1;01/01/2006;RUS
Rwanda;19248;2182;17066;2006;1;1;01/01/2006;RWA
Saint Kitts and Nevis;19248;2182;17066;2006;1;1;01/01/2006;KN1
Saint Lucia;38497;4365;34132;2006;1;1;01/01/2006;LCA
Saint Vincent and the Grenadines;19248;2182;17066;2006;1;1;01/01/2006;VCT
Samoa;19248;2182;17066;2006;1;1;01/01/2006;WSM
San Marino;57745;6547;51198;2006;1;1;01/01/2006;SMR
Sao Tome and Principe;19248;2182;17066;2006;1;1;01/01/2006;STP
Saudi Arabia;13724111;1556066;12168045;2006;1;1;01/01/2006;SAU
Senegal;96242;10912;85330;2006;1;1;01/01/2006;SEN
Yugoslavia;365720;41466;324254;2006;1;1;01/01/2006;YUG
Seychelles;38497;4365;34132;2006;1;1;01/01/2006;SYC
Sierra Leone;19248;2182;17066;2006;1;1;01/01/2006;SLE
Singapore;7468380;846780;6621600;2006;1;1;01/01/2006;SGP
Slovakia;981669;111304;870365;2006;1;1;01/01/2006;SVK
Slovenia;1578369;178959;1399410;2006;1;1;01/01/2006;SVN
Solomon Islands;19248;2182;17066;2006;1;1;01/01/2006;SLB
Somalia;19248;2182;17066;2006;1;1;01/01/2006;SOM
South Africa;5620534;637267;4983267;2006;1;1;01/01/2006;ZAF
Spain;48505975;5499701;43006274;2006;1;1;01/01/2006;ESP
Sri Lanka;327223;37101;290122;2006;1;1;01/01/2006;LKA
Sudan;153987;17460;136527;2006;1;1;01/01/2006;SDN
Suriname;19248;2182;17066;2006;1;1;01/01/2006;SUR
Swaziland;38497;4365;34132;2006;1;1;01/01/2006;SWZ
Sweden;19209906;2178056;17031850;2006;1;1;01/01/2006;SWE
Switzerland;23040338;2612358;20427980;2006;1;1;01/01/2006;CHE
Syrian Arab Republic;731439;82932;648507;2006;1;1;01/01/2006;SYR
Tajikistan;19248;2182;17066;2006;1;1;01/01/2006;TJK
Thailand;4022916;456126;3566790;2006;1;1;01/01/2006;THA
North Macedonia;115491;13095;102396;2006;1;1;01/01/2006;MKD
Timor-Leste;19248;2182;17066;2006;1;1;01/01/2006;TMP
Togo;19248;2182;17066;2006;1;1;01/01/2006;TGO
Tonga;19248;2182;17066;2006;1;1;01/01/2006;TON
Trinidad and Tobago;423465;48013;375452;2006;1;1;01/01/2006;TTO
Tunisia;615949;69838;546111;2006;1;1;01/01/2006;TUN
Turkey;7160406;767264;6393142;2006;1;1;01/01/2006;TUR
Turkmenistan;96242;10912;85330;2006;1;1;01/01/2006;TKM
Tuvalu;19248;2182;17066;2006;1;1;01/01/2006;TUV
Uganda;115491;13095;102396;2006;1;1;01/01/2006;UGA
Ukraine;750688;85115;665573;2006;1;1;01/01/2006;UKR
United Arab Emirates;4523375;512869;4010506;2006;1;1;01/01/2006;ARE
United Kingdom of Great Britain and  Northern Ireland;117934962;13371694;104563268;2006;1;1;01/01/2006;GBR
United Republic of Tanzania;115491;13095;102396;2006;1;1;01/01/2006;TZA
United States of America;423464855;-;423464855;2006;1;1;01/01/2006;USA
Uruguay;923924;104756;819168;2006;1;1;01/01/2006;URY
Uzbekistan;269478;30554;238924;2006;1;1;01/01/2006;UZB
Vanuatu;19248;2182;17066;2006;1;1;01/01/2006;VUT
Venezuela;3291477;373194;2918283;2006;1;1;01/01/2006;VEN
Viet Nam;404217;45831;358386;2006;1;1;01/01/2006;VNM
Yemen;115491;13095;102396;2006;1;1;01/01/2006;YEM
Zambia;38497;4365;34132;2006;1;1;01/01/2006;ZMB
Zimbabwe;134739;15277;119462;2006;1;1;01/01/2006;ZWE
Indonesia;2837493;310590;2526903;2005;1;1;01/01/2005;IDN
Afghanistan;39965;4375;35590;2005;1;1;01/01/2005;AFG
Albania;99912;10936;88976;2005;1;1;01/01/2005;ALB
Algeria;1518658;166231;1352427;2005;1;1;01/01/2005;DZA
Andorra;99912;10936;88976;2005;1;1;01/01/2005;AND
Angola;19982;2187;17795;2005;1;1;01/01/2005;AGO
Antigua and Barbuda;59947;6562;53385;2005;1;1;01/01/2005;ATG
Argentina;19103123;2091017;17012106;2005;1;1;01/01/2005;ARG
Armenia;39965;4375;35590;2005;1;1;01/01/2005;ARM
Australia;31811895;3482112;28329783;2005;1;1;01/01/2005;AUS
Austria;17164835;1878853;15285982;2005;1;1;01/01/2005;AUT
Azerbaijan;99912;10936;88976;2005;1;1;01/01/2005;AZE
Bahamas;259771;28434;231337;2005;1;1;01/01/2005;BHS
Bahrain;599471;65618;533853;2005;1;1;01/01/2005;BHR
Bangladesh;199824;21873;177951;2005;1;1;01/01/2005;BGD
Barbados;199824;21873;177951;2005;1;1;01/01/2005;BRB
Belarus;359682;39371;320311;2005;1;1;01/01/2005;BLR
Belgium;21361128;2338177;19022951;2005;1;1;01/01/2005;BEL
Belize;19982;2187;17795;2005;1;1;01/01/2005;BLZ
Benin;39965;4375;35590;2005;1;1;01/01/2005;BEN
Bhutan;19982;2187;17795;2005;1;1;01/01/2005;BTN
Bolivia;179841;19685;160156;2005;1;1;01/01/2005;BOL
Bosnia and Herzegovina;59947;6562;53385;2005;1;1;01/01/2005;BIH
Botswana;239788;26247;213541;2005;1;1;01/01/2005;BWA
Brazil;30433113;3331192;27101921;2005;1;1;01/01/2005;BRA
Brunei Darussalam;679400;74367;605033;2005;1;1;01/01/2005;BRN
Bulgaria;339700;37183;302517;2005;1;1;01/01/2005;BGR
Burkina Faso;39965;4375;35590;2005;1;1;01/01/2005;BFA
Burundi;19982;2187;17795;2005;1;1;01/01/2005;BDI
Cambodia;39965;4375;35590;2005;1;1;01/01/2005;KHM
Cameroon;159859;17498;142361;2005;1;1;01/01/2005;CMR
Canada;56210339;6152753;50057586;2005;1;1;01/01/2005;CAN
Cape Verde;19982;2187;17795;2005;1;1;01/01/2005;CPV
Central African Republic;19982;2187;17795;2005;1;1;01/01/2005;CAF
Chad;19982;2187;17795;2005;1;1;01/01/2005;TCD
Chile;4456063;487758;3968305;2005;1;1;01/01/2005;CHL
China;41023756;4490438;36533318;2005;1;1;01/01/2005;CHN
Colombia;3097264;339025;2758239;2005;1;1;01/01/2005;COL
Comoros;19982;2187;17795;2005;1;1;01/01/2005;COM
Congo;19982;2187;17795;2005;1;1;01/01/2005;COG
Costa Rica;599471;65618;533853;2005;1;1;01/01/2005;CRI
Côte d’Ivoire;199824;21873;177951;2005;1;1;01/01/2005;CIV
Croatia;739347;80928;658419;2005;1;1;01/01/2005;HRV
Cuba;859241;94052;765189;2005;1;1;01/01/2005;CUB
Cyprus;779312;85303;694009;2005;1;1;01/01/2005;CYP
Czech Republic;3656769;400268;3256501;2005;1;1;01/01/2005;CZE
Republic of Korea;199824;21873;177951;2005;1;1;01/01/2005;KOR
Democratic Republic of the Congo;59947;6562;53385;2005;1;1;01/01/2005;ZAR
Denmark;14347325;1570450;12776875;2005;1;1;01/01/2005;DNK
Djibouti;19982;2187;17795;2005;1;1;01/01/2005;DJI
Dominica;19982;2187;17795;2005;1;1;01/01/2005;DMA
Dominican Republic;699382;76554;622828;2005;1;1;01/01/2005;DOM
Ecuador;379665;41558;338107;2005;1;1;01/01/2005;ECU
Egypt;2397882;262471;2135411;2005;1;1;01/01/2005;EGY
El Salvador;439612;48120;391492;2005;1;1;01/01/2005;SLV
Equatorial Guinea;39965;4375;35590;2005;1;1;01/01/2005;GNQ
Eritrea;19982;1005;18977;2005;1;1;01/01/2005;ERI
Estonia;239788;26247;213541;2005;1;1;01/01/2005;EST
Ethiopia;79929;8749;71180;2005;1;1;01/01/2005;ETH
Fiji;79929;8749;71180;2005;1;1;01/01/2005;FJI
Finland;10650591;1165808;9484783;2005;1;1;01/01/2005;FIN
France;120493546;13189157;107304389;2005;1;1;01/01/2005;FRA
Gabon;179841;19685;160156;2005;1;1;01/01/2005;GAB
Gambia;19982;2187;17795;2005;1;1;01/01/2005;GMB
Georgia;59947;6562;53385;2005;1;1;01/01/2005;GEO
Germany;173087081;18946016;154141065;2005;1;1;01/01/2005;DEU
Ghana;79929;8749;71180;2005;1;1;01/01/2005;GHA
Greece;10590643;1159246;9431397;2005;1;1;01/01/2005;GRC
Grenada;19982;2187;17795;2005;1;1;01/01/2005;GRD
Guatemala;599471;65618;533853;2005;1;1;01/01/2005;GTM
Guinea;59947;6562;53385;2005;1;1;01/01/2005;GIN
Guinea-Bissau;19982;2187;17795;2005;1;1;01/01/2005;GNB
Guyana;19982;2187;17795;2005;1;1;01/01/2005;GUY
Haiti;59947;6562;53385;2005;1;1;01/01/2005;HTI
Honduras;99912;10936;88976;2005;1;1;01/01/2005;HND
Hungary;2517776;275594;2242182;2005;1;1;01/01/2005;HUN
Iceland;679400;74367;605033;2005;1;1;01/01/2005;ISL
India;8412568;920835;7491733;2005;1;1;01/01/2005;IND
Iran (Islamic Republic of);3137228;343399;2793829;2005;1;1;01/01/2005;IRN
Iraq;319718;34996;284722;2005;1;1;01/01/2005;IRQ
Ireland;6993821;765540;6228281;2005;1;1;01/01/2005;IRL
Israel;9331756;1021449;8310307;2005;1;1;01/01/2005;ISR
Italy;97613760;10684748;86929012;2005;1;1;01/01/2005;ITA
Jamaica;159859;17498;142361;2005;1;1;01/01/2005;JAM
Japan;389016312;42581510;346434802;2005;1;1;01/01/2005;JPN
Jordan;219806;24060;195746;2005;1;1;01/01/2005;JOR
Kazakhstan;499559;54681;444878;2005;1;1;01/01/2005;KAZ
Kenya;179841;19685;160156;2005;1;1;01/01/2005;KEN
Kiribati;19982;2187;17795;2005;1;1;01/01/2005;KIR
Kuwait;3237140;354336;2882804;2005;1;1;01/01/2005;KWT
Kyrgyzstan;19982;2187;17795;2005;1;1;01/01/2005;KGZ
Lao People’s Democratic Republic;19982;2187;17795;2005;1;1;01/01/2005;LAO
Latvia;299735;32809;266926;2005;1;1;01/01/2005;LVA
Lebanon;479576;52494;427082;2005;1;1;01/01/2005;LBN
Lesotho;19982;2187;17795;2005;1;1;01/01/2005;LSO
Liberia;19982;2187;17795;2005;1;1;01/01/2005;LBR
Libya;2637670;288718;2348952;2005;1;1;01/01/2005;LBY
Liechtenstein;99912;10936;88976;2005;1;1;01/01/2005;LIE
Lithuania;479576;52494;427082;2005;1;1;01/01/2005;LTU
Luxembourg;1538641;168419;1370222;2005;1;1;01/01/2005;LUX
Madagascar;59947;6562;53385;2005;1;1;01/01/2005;MDG
Malawi;19982;2187;17795;2005;1;1;01/01/2005;MWI
Malaysia;4056416;444013;3612403;2005;1;1;01/01/2005;MYS
Maldives;19982;2187;17795;2005;1;1;01/01/2005;MDV
Mali;39965;4375;35590;2005;1;1;01/01/2005;MLI
Malta;279753;30622;249131;2005;1;1;01/01/2005;MLT
Marshall Islands;19982;2187;17795;2005;1;1;01/01/2005;MHL
Mauritania;19982;2187;17795;2005;1;1;01/01/2005;MRT
Mauritius;219806;24060;195746;2005;1;1;01/01/2005;MUS
Mexico;37626758;4118604;33508154;2005;1;1;01/01/2005;MEX
Micronesia (Federated States of);19982;2187;17795;2005;1;1;01/01/2005;FSM
Monaco;59947;6562;53385;2005;1;1;01/01/2005;MCO
Mongolia;19982;2187;17795;2005;1;1;01/01/2005;MNG
Morocco;939170;102801;836369;2005;1;1;01/01/2005;MAR
Mozambique;19982;2187;17795;2005;1;1;01/01/2005;MOZ
Myanmar;199824;21873;177951;2005;1;1;01/01/2005;MMR
Namibia;119894;13124;106770;2005;1;1;01/01/2005;NAM
Nauru;19982;2187;17795;2005;1;1;01/01/2005;NRU
Nepal;79929;8749;71180;2005;1;1;01/01/2005;NPL
Netherlands;33770165;3696464;30073701;2005;1;1;01/01/2005;NLD
New Zealand;4416099;483384;3932715;2005;1;1;01/01/2005;NZL
Nicaragua;19982;2187;17795;2005;1;1;01/01/2005;NIC
Niger;19982;2187;17795;2005;1;1;01/01/2005;NER
Nigeria;839259;91865;747394;2005;1;1;01/01/2005;NGA
Norway;13568013;1485147;12082866;2005;1;1;01/01/2005;NOR
Oman;1398764;153108;1245656;2005;1;1;01/01/2005;OMN
Pakistan;1099029;120299;978730;2005;1;1;01/01/2005;PAK
Palau;19982;2187;17795;2005;1;1;01/01/2005;PLW
Panama;379665;41558;338107;2005;1;1;01/01/2005;PAN
Papua New Guinea;59947;6562;53385;2005;1;1;01/01/2005;PNG
Paraguay;239788;26247;213541;2005;1;1;01/01/2005;PRY
Peru;1838376;201228;1637148;2005;1;1;01/01/2005;PER
Philippines;1898323;207789;1690534;2005;1;1;01/01/2005;PHL
Poland;9211862;1008325;8203537;2005;1;1;01/01/2005;POL
Portugal;9391703;1028011;8363692;2005;1;1;01/01/2005;PRT
Qatar;1278870;139984;1138886;2005;1;1;01/01/2005;QAT
Republic of Korea;35888294;3928313;31959981;2005;1;1;01/01/2005;KOR
Moldova;19982;2187;17795;2005;1;1;01/01/2005;MDA
Romania;1198941;131235;1067706;2005;1;1;01/01/2005;ROM
Russian Federation;21980581;2405982;19574599;2005;1;1;01/01/2005;RUS
Rwanda;19982;2187;17795;2005;1;1;01/01/2005;RWA
Saint Kitts and Nevis;19982;2187;17795;2005;1;1;01/01/2005;KN1
Saint Lucia;39965;4375;35590;2005;1;1;01/01/2005;LCA
Saint Vincent and the Grenadines;19982;2187;17795;2005;1;1;01/01/2005;VCT
Samoa;19982;2187;17795;2005;1;1;01/01/2005;WSM
San Marino;59947;6562;53385;2005;1;1;01/01/2005;SMR
Sao Tome and Principe;19982;2187;17795;2005;1;1;01/01/2005;STP
Saudi Arabia;14247413;1559514;12687899;2005;1;1;01/01/2005;SAU
Senegal;99912;10936;88976;2005;1;1;01/01/2005;SEN
Yugoslavia;379665;41558;338107;2005;1;1;01/01/2005;YUG
Seychelles;39965;4375;35590;2005;1;1;01/01/2005;SYC
Sierra Leone;19982;2187;17795;2005;1;1;01/01/2005;SLE
Singapore;7753150;848656;6904494;2005;1;1;01/01/2005;SGP
Slovakia;1019100;111550;907550;2005;1;1;01/01/2005;SVK
Slovenia;1638552;179355;1459197;2005;1;1;01/01/2005;SVN
Solomon Islands;19982;2187;17795;2005;1;1;01/01/2005;SLB
Somalia;19982;2187;17795;2005;1;1;01/01/2005;SOM
South Africa;5834845;638679;5196166;2005;1;1;01/01/2005;ZAF
Spain;50355512;5511886;44843626;2005;1;1;01/01/2005;ESP
Sri Lanka;339700;37183;302517;2005;1;1;01/01/2005;LKA
Sudan;159859;17498;142361;2005;1;1;01/01/2005;SDN
Suriname;19982;2187;17795;2005;1;1;01/01/2005;SUR
Swaziland;39965;4375;35590;2005;1;1;01/01/2005;SWZ
Sweden;19942381;2182882;17759499;2005;1;1;01/01/2005;SWE
Switzerland;23918868;2618146;21300722;2005;1;1;01/01/2005;CHE
Syrian Arab Republic;759329;82231;677098;2005;1;1;01/01/2005;SYR
Tajikistan;19982;2187;17795;2005;1;1;01/01/2005;TJK
Thailand;4176310;457137;3719173;2005;1;1;01/01/2005;THA
North Macedonia;119894;13124;106770;2005;1;1;01/01/2005;MKD
Timor-Leste;19982;2187;17795;2005;1;1;01/01/2005;TMP
Togo;19982;2187;17795;2005;1;1;01/01/2005;TGO
Tonga;19982;2187;17795;2005;1;1;01/01/2005;TON
Trinidad and Tobago;439612;48120;391492;2005;1;1;01/01/2005;TTO
Tunisia;639435;69992;569443;2005;1;1;01/01/2005;TUN
Turkey;7433433;780796;6652637;2005;1;1;01/01/2005;TUR
Turkmenistan;99912;10936;88976;2005;1;1;01/01/2005;TKM
Tuvalu;19982;2187;17795;2005;1;1;01/01/2005;TUV
Uganda;119894;13124;106770;2005;1;1;01/01/2005;UGA
Ukraine;779312;85303;694009;2005;1;1;01/01/2005;UKR
United Arab Emirates;4695851;514005;4181846;2005;1;1;01/01/2005;ARE
United Kingdom of Great Britain and  Northern Ireland;122431834;13401321;109030513;2005;1;1;01/01/2005;GBR
United Republic of Tanzania;119894;13124;106770;2005;1;1;01/01/2005;TZA
United States of America;439611612;;439611612;2005;1;1;01/01/2005;USA
Uruguay;959153;104988;854165;2005;1;1;01/01/2005;URY
Uzbekistan;279753;30622;249131;2005;1;1;01/01/2005;UZB
Vanuatu;19982;2187;17795;2005;1;1;01/01/2005;VUT
Venezuela;3416981;374021;3042960;2005;1;1;01/01/2005;VEN
Viet Nam;419629;45932;373697;2005;1;1;01/01/2005;VNM
Yemen;119894;13124;106770;2005;1;1;01/01/2005;YEM
Zambia;39965;4375;35590;2005;1;1;01/01/2005;ZMB
Zimbabwe;139877;15311;124566;2005;1;1;01/01/2005;ZWE
Indonesia;2342051;302884;2039167;2004;1;1;01/01/2004;IDN
Afghanistan;32987;4266;28721;2004;1;1;01/01/2004;AFG
Albania;82467;10665;71802;2004;1;1;01/01/2004;ALB
Algeria;1253492;162107;1091385;2004;1;1;01/01/2004;DZA
Andorra;82467;10665;71802;2004;1;1;01/01/2004;AND
Angola;16493;2133;14360;2004;1;1;01/01/2004;AGO
Antigua and Barbuda;49480;6399;43081;2004;1;1;01/01/2004;ATG
Argentina;15767612;2039138;13728474;2004;1;1;01/01/2004;ARG
Armenia;32987;4266;28721;2004;1;1;01/01/2004;ARM
Australia;26257362;3395719;22861643;2004;1;1;01/01/2004;AUS
Austria;14167760;1832238;12335522;2004;1;1;01/01/2004;AUT
Azerbaijan;82467;10665;71802;2004;1;1;01/01/2004;AZE
Bahamas;214413;27729;186684;2004;1;1;01/01/2004;BHS
Bahrain;494800;63990;430810;2004;1;1;01/01/2004;BHR
Bangladesh;164933;21330;143603;2004;1;1;01/01/2004;BGD
Barbados;164933;21330;143603;2004;1;1;01/01/2004;BRB
Belarus;296880;38394;258486;2004;1;1;01/01/2004;BLR
Belgium;17631357;2280166;15351191;2004;1;1;01/01/2004;BEL
Belize;16493;2133;14360;2004;1;1;01/01/2004;BLZ
Benin;32987;4266;28721;2004;1;1;01/01/2004;BEN
Bhutan;16493;2133;14360;2004;1;1;01/01/2004;BTN
Bolivia;148440;19197;129243;2004;1;1;01/01/2004;BOL
Bosnia and Herzegovina;49480;6399;43081;2004;1;1;01/01/2004;BIH
Botswana;197920;25596;172324;2004;1;1;01/01/2004;BWA
Brazil;25119323;3248543;21870780;2004;1;1;01/01/2004;BRA
Brunei Darussalam;560773;72522;488251;2004;1;1;01/01/2004;BRN
Bulgaria;280387;36261;244126;2004;1;1;01/01/2004;BGR
Burkina Faso;32987;4266;28721;2004;1;1;01/01/2004;BFA
Burundi;16493;2133;14360;2004;1;1;01/01/2004;BDI
Cambodia;32987;4266;28721;2004;1;1;01/01/2004;KHM
Cameroon;131947;17064;114883;2004;1;1;01/01/2004;CMR
Canada;46395704;6000099;40395605;2004;1;1;01/01/2004;CAN
Cape Verde;16493;2133;14360;2004;1;1;01/01/2004;CPV
Central African Republic;16493;2133;14360;2004;1;1;01/01/2004;CAF
Chad;16493;2133;14360;2004;1;1;01/01/2004;TCD
Chile;3678010;475657;3202353;2004;1;1;01/01/2004;CHL
China;33860782;4379027;29481755;2004;1;1;01/01/2004;CHN
Colombia;2556464;330613;2225851;2004;1;1;01/01/2004;COL
Comoros;16493;2133;14360;2004;1;1;01/01/2004;COM
Congo;16493;2133;14360;2004;1;1;01/01/2004;COG
Costa Rica;494800;63990;430810;2004;1;1;01/01/2004;CRI
Côte d’Ivoire;164933;21330;143603;2004;1;1;01/01/2004;CIV
Croatia;610253;78921;531332;2004;1;1;01/01/2004;HRV
Cuba;709213;91718;617495;2004;1;1;01/01/2004;CUB
Cyprus;643239;83187;560052;2004;1;1;01/01/2004;CYP
Czech Republic;3018277;390337;2627940;2004;1;1;01/01/2004;CZE
Democratic People’s Republic of Korea;164933;21330;143603;2004;1;1;01/01/2004;PRK
Democratic Republic of the Congo;49480;6399;43081;2004;1;1;01/01/2004;ZAR
Denmark;11842202;1531486;10310716;2004;1;1;01/01/2004;DNK
Djibouti;16493;2133;14360;2004;1;1;01/01/2004;DJI
Dominica;16493;2133;14360;2004;1;1;01/01/2004;DMA
Dominican Republic;577266;74655;502611;2004;1;1;01/01/2004;DOM
Ecuador;313373;40527;272846;2004;1;1;01/01/2004;ECU
Egypt;1979198;255959;1723239;2004;1;1;01/01/2004;EGY
El Salvador;362853;46926;315927;2004;1;1;01/01/2004;SLV
Equatorial Guinea;32987;4266;28721;2004;1;1;01/01/2004;GNQ
Eritrea;16493;(7174)a;23667;2004;1;1;01/01/2004;ERI
Estonia;197920;25596;172324;2004;1;1;01/01/2004;EST
Ethiopia;65973;8532;57441;2004;1;1;01/01/2004;ETH
Fiji;65973;8532;57441;2004;1;1;01/01/2004;FJI
Finland;8790939;1136883;7654056;2004;1;1;01/01/2004;FIN
France;99454708;12861927;86592781;2004;1;1;01/01/2004;FRA
Gabon;148440;19197;129243;2004;1;1;01/01/2004;GAB
Gambia;16493;2133;14360;2004;1;1;01/01/2004;GMB
Georgia;49480;6399;43081;2004;1;1;01/01/2004;GEO
Germany;142865121;18475955;124389166;2004;1;1;01/01/2004;DEU
Ghana;65973;8532;57441;2004;1;1;01/01/2004;GHA
Greece;8741459;1130484;7610975;2004;1;1;01/01/2004;GRC
Grenada;16493;2133;14360;2004;1;1;01/01/2004;GRD
Guatemala;494800;63990;430810;2004;1;1;01/01/2004;GTM
Guinea;49480;6399;43081;2004;1;1;01/01/2004;GIN
Guinea-Bissau;16493;2133;14360;2004;1;1;01/01/2004;GNB
Guyana;16493;2133;14360;2004;1;1;01/01/2004;GUY
Haiti;49480;6399;43081;2004;1;1;01/01/2004;HTI
Honduras;82467;10665;71802;2004;1;1;01/01/2004;HND
Hungary;2078158;268757;1809401;2004;1;1;01/01/2004;HUN
Iceland;560773;72522;488251;2004;1;1;01/01/2004;ISL
India;6943687;897988;6045699;2004;1;1;01/01/2004;IND
Iran (Islamic Republic of);2589451;334879;2254572;2004;1;1;01/01/2004;IRN
Iraq;263893;34128;229765;2004;1;1;01/01/2004;IRQ
Ireland;5772661;746546;5026115;2004;1;1;01/01/2004;IRL
Israel;7702380;996106;6706274;2004;1;1;01/01/2004;ISR
Italy;80569859;10419654;70150205;2004;1;1;01/01/2004;ITA
Jamaica;131947;17064;114883;2004;1;1;01/01/2004;JAM
Japan;321091915;41525039;279566876;2004;1;1;01/01/2004;JPN
Jordan;181427;23463;157964;2004;1;1;01/01/2004;JOR
Kazakhstan;412333;53325;359008;2004;1;1;01/01/2004;KAZ
Kenya;148440;19197;129243;2004;1;1;01/01/2004;KEN
Kiribati;16493;2133;14360;2004;1;1;01/01/2004;KIR
Kuwait;2671918;345544;2326374;2004;1;1;01/01/2004;KWT
Kyrgyzstan;16493;2133;14360;2004;1;1;01/01/2004;KGZ
Lao People’s Democratic Republic;16493;2133;14360;2004;1;1;01/01/2004;LAO
Latvia;247400;31995;215405;2004;1;1;01/01/2004;LVA
Lebanon;395840;51192;344648;2004;1;1;01/01/2004;LBN
Lesotho;16493;2133;14360;2004;1;1;01/01/2004;LSO
Liberia;16493;2133;14360;2004;1;1;01/01/2004;LBR
Libya;2177118;281555;1895563;2004;1;1;01/01/2004;LBY
Liechtenstein;82467;10665;71802;2004;1;1;01/01/2004;LIE
Lithuania;395840;51192;344648;2004;1;1;01/01/2004;LTU
Luxembourg;1269986;164240;1105746;2004;1;1;01/01/2004;LUX
Madagascar;49480;6399;43081;2004;1;1;01/01/2004;MDG
Malawi;16493;2133;14360;2004;1;1;01/01/2004;MWI
Malaysia;3348144;432997;2915147;2004;1;1;01/01/2004;MYS
Maldives;16493;2133;14360;2004;1;1;01/01/2004;MDV
Mali;32987;4266;28721;2004;1;1;01/01/2004;MLI
Malta;230907;29862;201045;2004;1;1;01/01/2004;MLT
Marshall Islands;16493;2133;14360;2004;1;1;01/01/2004;MHL
Mauritania;16493;2133;14360;2004;1;1;01/01/2004;MRT
Mauritius;181427;23463;157964;2004;1;1;01/01/2004;MUS
Mexico;31056918;4016419;27040499;2004;1;1;01/01/2004;MEX
Micronesia (Federated States of);16493;2133;14360;2004;1;1;01/01/2004;FSM
Monaco;49480;6399;43081;2004;1;1;01/01/2004;MCO
Mongolia;16493;2133;14360;2004;1;1;01/01/2004;MNG
Morocco;775186;100250;674936;2004;1;1;01/01/2004;MAR
Mozambique;16493;2133;14360;2004;1;1;01/01/2004;MOZ
Myanmar;164933;21330;143603;2004;1;1;01/01/2004;MMR
Namibia;98960;12798;86162;2004;1;1;01/01/2004;NAM
Nauru;16493;2133;14360;2004;1;1;01/01/2004;NRU
Nepal;65973;8532;57441;2004;1;1;01/01/2004;NPL
Netherlands;27873707;3604752;24268955;2004;1;1;01/01/2004;NLD
New Zealand;3645023;471391;3173632;2004;1;1;01/01/2004;NZL
Nicaragua;16493;2133;14360;2004;1;1;01/01/2004;NIC
Niger;16493;2133;14360;2004;1;1;01/01/2004;NER
Nigeria;692719;89585;603134;2004;1;1;01/01/2004;NGA
Norway;11198963;1448300;9750663;2004;1;1;01/01/2004;NOR
Oman;1154532;149309;1005223;2004;1;1;01/01/2004;OMN
Pakistan;907133;117314;789819;2004;1;1;01/01/2004;PAK
Palau;16493;2133;14360;2004;1;1;01/01/2004;PLW
Panama;313373;40527;272846;2004;1;1;01/01/2004;PAN
Papua New Guinea;49480;6399;43081;2004;1;1;01/01/2004;PNG
Paraguay;197920;25596;172324;2004;1;1;01/01/2004;PRY
Peru;1517385;196235;1321150;2004;1;1;01/01/2004;PER
Philippines;1566865;202634;1364231;2004;1;1;01/01/2004;PHL
Poland;7603420;983308;6620112;2004;1;1;01/01/2004;POL
Portugal;7751860;1002505;6749355;2004;1;1;01/01/2004;PRT
Qatar;1055572;136511;919061;2004;1;1;01/01/2004;QAT
Republic of Korea;29621999;3830849;25791150;2004;1;1;01/01/2004;KOR
Moldova;16493;2133;14360;2004;1;1;01/01/2004;MDA
Romania;989599;127979;861620;2004;1;1;01/01/2004;ROM
Russian Federation;18142650;2346288;15796362;2004;1;1;01/01/2004;RUS
Rwanda;16493;2133;14360;2004;1;1;01/01/2004;RWA
Saint Kitts and Nevis;16493;2133;14360;2004;1;1;01/01/2004;KN1
Saint Lucia;32987;4266;28721;2004;1;1;01/01/2004;LCA
Saint Vincent and the Grenadines;16493;2133;14360;2004;1;1;01/01/2004;VCT
Samoa;16493;2133;14360;2004;1;1;01/01/2004;WSM
San Marino;49480;6399;43081;2004;1;1;01/01/2004;SMR
Sao Tome and Principe;16493;2133;14360;2004;1;1;01/01/2004;STP
Saudi Arabia;11759736;1520821;10238915;2004;1;1;01/01/2004;SAU
Senegal;82467;10665;71802;2004;1;1;01/01/2004;SEN
Yugoslavia;313373;40527;272846;2004;1;1;01/01/2004;YUG
Seychelles;32987;4266;28721;2004;1;1;01/01/2004;SYC
Sierra Leone;16493;2133;14360;2004;1;1;01/01/2004;SLE
Singapore;6399407;827600;5571807;2004;1;1;01/01/2004;SGP
Slovakia;841159;108782;732377;2004;1;1;01/01/2004;SVK
Slovenia;1352452;174905;1177547;2004;1;1;01/01/2004;SVN
Solomon Islands;16493;2133;14360;2004;1;1;01/01/2004;SLB
Somalia;16493;2133;14360;2004;1;1;01/01/2004;SOM
South Africa;4816049;622833;4193216;2004;1;1;01/01/2004;ZAF
Spain;41563161;5375133;36188028;2004;1;1;01/01/2004;ESP
Sri Lanka;280387;36261;244126;2004;1;1;01/01/2004;LKA
Sudan;131947;17064;114883;2004;1;1;01/01/2004;SDN
Suriname;16493;2133;14360;2004;1;1;01/01/2004;SUR
Swaziland;32987;4266;28721;2004;1;1;01/01/2004;SWZ
Sweden;16460331;2128723;14331608;2004;1;1;01/01/2004;SWE
Switzerland;19742502;2553188;17189314;2004;1;1;01/01/2004;CHE
Syrian Arab Republic;626746;79704b;547042;2004;1;1;01/01/2004;SYR
Tajikistan;16493;2133;14360;2004;1;1;01/01/2004;TJK
Thailand;3447104;445795;3001309;2004;1;1;01/01/2004;THA
North Macedonia;98960;12798;86162;2004;1;1;01/01/2004;MKD
Timor-Leste;16493;2133;14360;2004;1;1;01/01/2004;TMP
Togo;16493;2133;14360;2004;1;1;01/01/2004;TGO
Tonga;16493;2133;14360;2004;1;1;01/01/2004;TON
Trinidad and Tobago;362853;46926;315927;2004;1;1;01/01/2004;TTO
Tunisia;527786;68256;459530;2004;1;1;01/01/2004;TUN
Turkey;6135514;764231b;5371283;2004;1;1;01/01/2004;TUR
Turkmenistan;82467;10665;71802;2004;1;1;01/01/2004;TKM
Tuvalu;16493;2133;14360;2004;1;1;01/01/2004;TUV
Uganda;98960;12798;86162;2004;1;1;01/01/2004;UGA
Ukraine;643239;83187;560052;2004;1;1;01/01/2004;UKR
United Arab Emirates;3875930;501252;3374678;2004;1;1;01/01/2004;ARE
United Kingdom of Great Britain and  Northern Ireland;101054559;13068827;87985732;2004;1;1;01/01/2004;GBR
United Republic of Tanzania;98960;12798;86162;2004;1;1;01/01/2004;TZA
United States of America;362852996;-b;362852996;2004;1;1;01/01/2004;USA
Uruguay;791679;102383;689296;2004;1;1;01/01/2004;URY
Uzbekistan;230907;29862;201045;2004;1;1;01/01/2004;UZB
Vanuatu;16493;2133;14360;2004;1;1;01/01/2004;VUT
Venezuela;2820357;364741;2455616;2004;1;1;01/01/2004;VEN
Viet Nam;346360;44793;301567;2004;1;1;01/01/2004;VNM
Yemen;98960;12798;86162;2004;1;1;01/01/2004;YEM
Zambia;32987;4266;28721;2004;1;1;01/01/2004;ZMB
Zimbabwe;115453;14931;100522;2004;1;1;01/01/2004;ZWE
Indonesia;3104319;404068;2700251;2003;1;1;01/01/2003;IDN
Afghanistan;15522;2020;13502;2003;1;1;01/01/2003;AFG
Albania;46565;6061;40504;2003;1;1;01/01/2003;ALB
Algeria;1086512;141424;945088;2003;1;1;01/01/2003;DZA
Andorra;62086;8081;54005;2003;1;1;01/01/2003;AND
Angola;31043;4041;27002;2003;1;1;01/01/2003;AGO
Antigua and Barbuda;31043;4041;27002;2003;1;1;01/01/2003;ATG
Argentina;15040426;1957711;13082715;2003;1;1;01/01/2003;ARG
Armenia;31043;4041;27002;2003;1;1;01/01/2003;ARM
Australia;25253636;3287096;21966540;2003;1;1;01/01/2003;AUS
Austria;14698951;1913264;12785687;2003;1;1;01/01/2003;AUT
Azerbaijan;62086;8081;54005;2003;1;1;01/01/2003;AZE
Bahamas;186259;24244;162015;2003;1;1;01/01/2003;BHS
Bahrain;279389;36366;243023;2003;1;1;01/01/2003;BHR
Bangladesh;155216;20204;135012;2003;1;1;01/01/2003;BGD
Barbados;139694;18183;121511;2003;1;1;01/01/2003;BRB
Belarus;294910;38387;256523;2003;1;1;01/01/2003;BLR
Belgium;17523882;2280966;15242916;2003;1;1;01/01/2003;BEL
Belize;15522;2020;13502;2003;1;1;01/01/2003;BLZ
Benin;31043;4041;27002;2003;1;1;01/01/2003;BEN
Bhutan;15522;2020;13502;2003;1;1;01/01/2003;BTN
Bolivia;124173;16163;108010;2003;1;1;01/01/2003;BOL
Bosnia and Herzegovina;62086;8081;54005;2003;1;1;01/01/2003;BIH
Botswana;155216;20204;135012;2003;1;1;01/01/2003;BWA
Brazil;37096614;4828616;32267998;2003;1;1;01/01/2003;BRA
Brunei Darussalam;512213;66671;445542;2003;1;1;01/01/2003;BRN
Bulgaria;201781;26265;175516;2003;1;1;01/01/2003;BGR
Burkina Faso;31043;4041;27002;2003;1;1;01/01/2003;BFA
Burundi;15522;2020;13502;2003;1;1;01/01/2003;BDI
Cambodia;31043;4041;27002;2003;1;1;01/01/2003;KHM
Cameroon;139694;18183;121511;2003;1;1;01/01/2003;CMR
Canada;39704242;5168034;34536208;2003;1;1;01/01/2003;CAN
Cape Verde;15522;2020;13502;2003;1;1;01/01/2003;CPV
Central African Republic;15522;2020;13502;2003;1;1;01/01/2003;CAF
Chad;15522;2020;13502;2003;1;1;01/01/2003;TCD
Chile;3290578;428313;2862265;2003;1;1;01/01/2003;CHL
China;23779085;3095163;20683922;2003;1;1;01/01/2003;CHN
Colombia;3119841;406089;2713752;2003;1;1;01/01/2003;COL
Comoros;15522;2020;13502;2003;1;1;01/01/2003;COM
Congo;15522;2020;13502;2003;1;1;01/01/2003;COG
Costa Rica;310432;40407;270025;2003;1;1;01/01/2003;CRI
Côte d’Ivoire;139694;18183;121511;2003;1;1;01/01/2003;CIV
Croatia;605342;78793;526549;2003;1;1;01/01/2003;HRV
Cuba;465648;60610;405038;2003;1;1;01/01/2003;CUB
Cyprus;589821;76773;513048;2003;1;1;01/01/2003;CYP
Czech Republic;3150884;410129;2740755;2003;1;1;01/01/2003;CZE
Democratic People’s Republic of Korea;139694;18183;121511;2003;1;1;01/01/2003;PRK
Democratic Republic of the Congo;62086;8081;54005;2003;1;1;01/01/2003;ZAR
Denmark;11625675;1513236;10112439;2003;1;1;01/01/2003;DNK
Djibouti;15522;2020;13502;2003;1;1;01/01/2003;DJI
Dominica;15522;2020;13502;2003;1;1;01/01/2003;DMA
Dominican Republic;356997;46468;310529;2003;1;1;01/01/2003;DOM
Ecuador;388040;50509;337531;2003;1;1;01/01/2003;ECU
Egypt;1257249;163648;1093601;2003;1;1;01/01/2003;EGY
El Salvador;279389;36366;243023;2003;1;1;01/01/2003;SLV
Equatorial Guinea;15522;2020;13502;2003;1;1;01/01/2003;GNQ
Eritrea;15522;2020;13502;2003;1;1;01/01/2003;ERI
Estonia;155216;20204;135012;2003;1;1;01/01/2003;EST
Ethiopia;62086;8081;54005;2003;1;1;01/01/2003;ETH
Fiji;62086;8081;54005;2003;1;1;01/01/2003;FJI
Finland;8102273;1054618;7047655;2003;1;1;01/01/2003;FIN
France;100362639;13063528;87299111;2003;1;1;01/01/2003;FRA
Gabon;217302;28285;189017;2003;1;1;01/01/2003;GAB
Gambia;15522;2020;13502;2003;1;1;01/01/2003;GMB
Georgia;77608;10102;67506;2003;1;1;01/01/2003;GEO
Germany;151630470;19736717;131893753;2003;1;1;01/01/2003;DEU
Ghana;77608;10102;67506;2003;1;1;01/01/2003;GHA
Greece;8366140;1088964;7277176;2003;1;1;01/01/2003;GRC
Grenada;15522;2020;13502;2003;1;1;01/01/2003;GRD
Guatemala;419083;54549;364534;2003;1;1;01/01/2003;GTM
Guinea;46565;6061;40504;2003;1;1;01/01/2003;GIN
Guinea-Bissau;15522;2020;13502;2003;1;1;01/01/2003;GNB
Guyana;15522;2020;13502;2003;1;1;01/01/2003;GUY
Haiti;31043;4041;27002;2003;1;1;01/01/2003;HTI
Honduras;77608;10102;67506;2003;1;1;01/01/2003;HND
Hungary;1862591;242441;1620150;2003;1;1;01/01/2003;HUN
Iceland;512213;66671;445542;2003;1;1;01/01/2003;ISL
India;5292864;688937;4603927;2003;1;1;01/01/2003;IND
Iran (Islamic Republic of);4221874;549533;3672341;2003;1;1;01/01/2003;IRN
Iraq;2110937;274767;1836170;2003;1;1;01/01/2003;IRQ
Ireland;4563349;593981;3969368;2003;1;1;01/01/2003;IRL
Israel;6441462;838442;5603020;2003;1;1;01/01/2003;ISR
Italy;78613003;10232525;68380478;2003;1;1;01/01/2003;ITA
Jamaica;62086;8081;54005;2003;1;1;01/01/2003;JAM
Japan;302915585;39428480;263487105;2003;1;1;01/01/2003;JPN
Jordan;124173;16163;108010;2003;1;1;01/01/2003;JOR
Kazakhstan;434605;56570;378035;2003;1;1;01/01/2003;KAZ
Kenya;124173;16163;108010;2003;1;1;01/01/2003;KEN
Kiribati;15522;2020;13502;2003;1;1;01/01/2003;KIR
Kuwait;2281675;296990;1984685;2003;1;1;01/01/2003;KWT
Kyrgyzstan;15522;2020;13502;2003;1;1;01/01/2003;KGZ
Lao People’s Democratic Republic;15522;2020;13502;2003;1;1;01/01/2003;LAO
Latvia;155216;20204;135012;2003;1;1;01/01/2003;LVA
Lebanon;186259;24244;162015;2003;1;1;01/01/2003;LBN
Lesotho;15522;2020;13502;2003;1;1;01/01/2003;LSO
Liberia;15522;2020;13502;2003;1;1;01/01/2003;LBR
Libya;1039947;135363;904584;2003;1;1;01/01/2003;LBY
Liechtenstein;93129;12122;81007;2003;1;1;01/01/2003;LIE
Lithuania;263867;34346;229521;2003;1;1;01/01/2003;LTU
Luxembourg;1241728;161627;1080101;2003;1;1;01/01/2003;LUX
Madagascar;46565;6061;40504;2003;1;1;01/01/2003;MDG
Malawi;31043;4041;27002;2003;1;1;01/01/2003;MWI
Malaysia;3647575;474780;3172795;2003;1;1;01/01/2003;MYS
Maldives;15522;2020;13502;2003;1;1;01/01/2003;MDV
Mali;31043;4041;27002;2003;1;1;01/01/2003;MLI
Malta;232824;30305;202519;2003;1;1;01/01/2003;MLT
Marshall Islands;15522;2020;13502;2003;1;1;01/01/2003;MHL
Mauritania;15522;2020;13502;2003;1;1;01/01/2003;MRT
Mauritius;170737;22224;148513;2003;1;1;01/01/2003;MUS
Mexico;16856453;2194091;14662362;2003;1;1;01/01/2003;MEX
Micronesia (Federated States of);15522;2020;13502;2003;1;1;01/01/2003;FSM
Monaco;62086;8081;54005;2003;1;1;01/01/2003;MCO
Mongolia;15522;2020;13502;2003;1;1;01/01/2003;MNG
Morocco;682950;88895;594055;2003;1;1;01/01/2003;MAR
Mozambique;15522;2020;13502;2003;1;1;01/01/2003;MOZ
Myanmar;155216;20204;135012;2003;1;1;01/01/2003;MMR
Namibia;108651;14143;94508;2003;1;1;01/01/2003;NAM
Nauru;15522;2020;13502;2003;1;1;01/01/2003;NRU
Nepal;62086;8081;54005;2003;1;1;01/01/2003;NPL
Netherlands;26976534;3511354;23465180;2003;1;1;01/01/2003;NLD
New Zealand;3740705;486902;3253803;2003;1;1;01/01/2003;NZL
Nicaragua;15522;2020;13502;2003;1;1;01/01/2003;NIC
Niger;15522;2020;13502;2003;1;1;01/01/2003;NER
Nigeria;1055468;137383;918085;2003;1;1;01/01/2003;NGA
Norway;10026951;1305141;8721810;2003;1;1;01/01/2003;NOR
Oman;946817;123241;823576;2003;1;1;01/01/2003;OMN
Pakistan;946817;123241;823576;2003;1;1;01/01/2003;PAK
Palau;15522;2020;13502;2003;1;1;01/01/2003;PLW
Panama;279389;36366;243023;2003;1;1;01/01/2003;PAN
Papua New Guinea;93129;12122;81007;2003;1;1;01/01/2003;PNG
Paraguay;248345;32326;216019;2003;1;1;01/01/2003;PRY
Peru;1831548;238400;1593148;2003;1;1;01/01/2003;PER
Philippines;1552159;202034;1350125;2003;1;1;01/01/2003;PHL
Poland;5867163;763689;5103474;2003;1;1;01/01/2003;POL
Portugal;7170977;933398;6237579;2003;1;1;01/01/2003;PRT
Qatar;527734;68692;459042;2003;1;1;01/01/2003;QAT
Republic of Korea;28730474;3739652;24990822;2003;1;1;01/01/2003;KOR
Moldova;31043;4041;27002;2003;1;1;01/01/2003;MDA
Romania;900252;117180;783072;2003;1;1;01/01/2003;ROM
Russian Federation;18625915;2424410;16201505;2003;1;1;01/01/2003;RUS
Rwanda;15522;2020;13502;2003;1;1;01/01/2003;RWA
Saint Kitts and Nevis;15522;2020;13502;2003;1;1;01/01/2003;KN1
Saint Lucia;31043;4041;27002;2003;1;1;01/01/2003;LCA
Saint Vincent and the Grenadines;15522;2020;13502;2003;1;1;01/01/2003;VCT
Samoa;15522;2020;13502;2003;1;1;01/01/2003;WSM
San Marino;31043;4041;27002;2003;1;1;01/01/2003;SMR
Sao Tome and Principe;15522;2020;13502;2003;1;1;01/01/2003;STP
Saudi Arabia;8598964;1119269;7479695;2003;1;1;01/01/2003;SAU
Senegal;77608;10102;67506;2003;1;1;01/01/2003;SEN
Seychelles;31043;4041;27002;2003;1;1;01/01/2003;SYC
Sierra Leone;15522;2020;13502;2003;1;1;01/01/2003;SLE
Singapore;6099987;793994;5305993;2003;1;1;01/01/2003;SGP
Slovakia;667429;86875;580554;2003;1;1;01/01/2003;SVK
Slovenia;1257249;163648;1093601;2003;1;1;01/01/2003;SVN
Solomon Islands;15522;2020;13502;2003;1;1;01/01/2003;SLB
Somalia;15522;2020;13502;2003;1;1;01/01/2003;SOM
South Africa;6332811;824300;5508511;2003;1;1;01/01/2003;ZAF
Spain;39095020;5088735;34006285;2003;1;1;01/01/2003;ESP
Sri Lanka;248345;32326;216019;2003;1;1;01/01/2003;LKA
Sudan;93129;12122;81007;2003;1;1;01/01/2003;SDN
Suriname;31043;4041;27002;2003;1;1;01/01/2003;SUR
Swaziland;31043;4041;27002;2003;1;1;01/01/2003;SWZ
Sweden;15936799;2074386;13862413;2003;1;1;01/01/2003;SWE
Switzerland;19774513;2573915;17200598;2003;1;1;01/01/2003;CHE
Syrian Arab Republic;1241728;161627;1080101;2003;1;1;01/01/2003;SYR
Tajikistan;15522;2020;13502;2003;1;1;01/01/2003;TJK
Thailand;4563349;593981;3969368;2003;1;1;01/01/2003;THA
North Macedonia;93129;12122;81007;2003;1;1;01/01/2003;MKD
Timor-Leste;15522;2020;13502;2003;1;1;01/01/2003;TMP
Togo;15522;2020;13502;2003;1;1;01/01/2003;TGO
Tonga;15522;2020;13502;2003;1;1;01/01/2003;TON
Trinidad and Tobago;248345;32326;216019;2003;1;1;01/01/2003;TTO
Tunisia;465648;60610;405038;2003;1;1;01/01/2003;TUN
Turkey;6829502;863496a;5966006;2003;1;1;01/01/2003;TUR
Turkmenistan;46565;6061;40504;2003;1;1;01/01/2003;TKM
Tuvalu;15522;2020;13502;2003;1;1;01/01/2003;TUV
Uganda;77608;10102;67506;2003;1;1;01/01/2003;UGA
Ukraine;822644;107078;715566;2003;1;1;01/01/2003;UKR
United Arab Emirates;3135362;408109;2727253;2003;1;1;01/01/2003;ARE
United Kingdom of Great Britain and  Northern Ireland;85927555;11184611;74742944;2003;1;1;01/01/2003;GBR
United Republic of Tanzania;62086;8081;54005;2003;1;1;01/01/2003;TZA
United States of America;341475110;0a;341475110;2003;1;1;01/01/2003;USA
Uruguay;1241728;161627;1080101;2003;1;1;01/01/2003;URY
Uzbekistan;170737;22224;148513;2003;1;1;01/01/2003;UZB
Vanuatu;15522;2020;13502;2003;1;1;01/01/2003;VUT
Venezuela;3228492;420231;2808261;2003;1;1;01/01/2003;VEN
Viet Nam;248345;32326;216019;2003;1;1;01/01/2003;VNM
Yemen;93129;12122;81007;2003;1;1;01/01/2003;YEM
Yugoslavia;310432;40407;270025;2003;1;1;01/01/2003;YUG
Zambia;31043;4041;27002;2003;1;1;01/01/2003;ZMB
Zimbabwe;124173;16163;108010;2003;1;1;01/01/2003;ZWE
Indonesia;2586288;354300;2231988;2002;1;1;01/01/2002;IDN
Afghanistan;90070;12339;77731;2002;1;1;01/01/2002;AFG
Albania;38601;5288;33313;2002;1;1;01/01/2002;ALB
Algeria;913565;125151;788414;2002;1;1;01/01/2002;DZA
Andorra;51468;7051;44417;2002;1;1;01/01/2002;AND
Angola;25734;3525;22209;2002;1;1;01/01/2002;AGO
Antigua and Barbuda;25734;3525;22209;2002;1;1;01/01/2002;ATG
Argentina;14912975;2042956;12870019;2002;1;1;01/01/2002;ARG
Armenia;25734;3525;22209;2002;1;1;01/01/2002;ARM
Australia;21102053;2890810;18211243;2002;1;1;01/01/2002;AUS
Austria;12275219;1681605;10593614;2002;1;1;01/01/2002;AUT
Azerbaijan;51468;7051;44417;2002;1;1;01/01/2002;AZE
Bahamas;154405;21152;133253;2002;1;1;01/01/2002;BHS
Bahrain;231608;31728;199880;2002;1;1;01/01/2002;BHR
Bangladesh;128671;17627;111044;2002;1;1;01/01/2002;BGD
Barbados;115804;15864;99940;2002;1;1;01/01/2002;BRB
Belarus;244475;33491;210984;2002;1;1;01/01/2002;BLR
Belgium;14642766;2005940;12636826;2002;1;1;01/01/2002;BEL
Belize;12867;1763;11104;2002;1;1;01/01/2002;BLZ
Benin;25734;3525;22209;2002;1;1;01/01/2002;BEN
Bhutan;12867;1763;11104;2002;1;1;01/01/2002;BTN
Bolivia;102937;14101;88836;2002;1;1;01/01/2002;BOL
Bosnia and Herzegovina;51468;7051;44417;2002;1;1;01/01/2002;BIH
Botswana;128671;17627;111044;2002;1;1;01/01/2002;BWA
Brazil;26930852;3689308;23241544;2002;1;1;01/01/2002;BRA
Brunei Darussalam;424615;58169;366446;2002;1;1;01/01/2002;BRN
Bulgaria;167272;22915;144357;2002;1;1;01/01/2002;BGR
Burkina Faso;25734;3525;22209;2002;1;1;01/01/2002;BFA
Burundi;12867;1763;11104;2002;1;1;01/01/2002;BDI
Cambodia;25734;3525;22209;2002;1;1;01/01/2002;KHM
Cameroon;115804;15864;99940;2002;1;1;01/01/2002;CMR
Canada;33184265;4545975;28638290;2002;1;1;01/01/2002;CAN
Cape Verde;12867;1763;11104;2002;1;1;01/01/2002;CPV
Central African Republic;12867;1763;11104;2002;1;1;01/01/2002;CAF
Chad;12867;1763;11104;2002;1;1;01/01/2002;TCD
Chile;2406149;329623;2076526;2002;1;1;01/01/2002;CHL
China;19879678;2723354;17156324;2002;1;1;01/01/2002;CHN
Colombia;2200275;301420;1898855;2002;1;1;01/01/2002;COL
Comoros;12867;1763;11104;2002;1;1;01/01/2002;COM
Congo;12867;1763;11104;2002;1;1;01/01/2002;COG
Costa Rica;257342;35254;222088;2002;1;1;01/01/2002;CRI
Côte d’Ivoire;115804;15864;99940;2002;1;1;01/01/2002;CIV
Croatia;501817;68745;433072;2002;1;1;01/01/2002;HRV
Cuba;386013;52881;333132;2002;1;1;01/01/2002;CUB
Cyprus;488950;66982;421968;2002;1;1;01/01/2002;CYP
Czech Republic;2213142;303182;1909960;2002;1;1;01/01/2002;CZE
Democratic People’s Republic of Korea;115804;15864;99940;2002;1;1;01/01/2002;PRK
Democratic Republic of the Congo;51468;7051;44417;2002;1;1;01/01/2002;ZAR
Denmark;9714665;1330830;8383835;2002;1;1;01/01/2002;DNK
Djibouti;12867;1763;11104;2002;1;1;01/01/2002;DJI
Dominica;12867;1763;11104;2002;1;1;01/01/2002;DMA
Dominican Republic;295943;40542;255401;2002;1;1;01/01/2002;DOM
Ecuador;321678;44067;277611;2002;1;1;01/01/2002;ECU
Egypt;1042236;142778;899458;2002;1;1;01/01/2002;EGY
El Salvador;231608;31728;199880;2002;1;1;01/01/2002;SLV
Equatorial Guinea;12867;1763;11104;2002;1;1;01/01/2002;GNQ
Eritrea;12867;1763;11104;2002;1;1;01/01/2002;ERI
Estonia;128671;17627;111044;2002;1;1;01/01/2002;EST
Ethiopia;51468;7051;44417;2002;1;1;01/01/2002;ETH
Fiji;51468;7051;44417;2002;1;1;01/01/2002;FJI
Finland;6768098;927174;5840924;2002;1;1;01/01/2002;FIN
France;83842059;11485681;72356378;2002;1;1;01/01/2002;FRA
Gabon;180140;24678;155462;2002;1;1;01/01/2002;GAB
Gambia;12867;1763;11104;2002;1;1;01/01/2002;GMB
Georgia;64336;8813;55523;2002;1;1;01/01/2002;GEO
Germany;126676654;17353673;109322981;2002;1;1;01/01/2002;DEU
Ghana;64336;8813;55523;2002;1;1;01/01/2002;GHA
Greece;6986838;957140;6029698;2002;1;1;01/01/2002;GRC
Grenada;12867;1763;11104;2002;1;1;01/01/2002;GRD
Guatemala;347412;47593;299819;2002;1;1;01/01/2002;GTM
Guinea;38601;5288;33313;2002;1;1;01/01/2002;GIN
Guinea-Bissau;12867;1763;11104;2002;1;1;01/01/2002;GNB
Guyana;12867;1763;11104;2002;1;1;01/01/2002;GUY
Haiti;25734;3525;22209;2002;1;1;01/01/2002;HTI
Honduras;51468;7051;44417;2002;1;1;01/01/2002;HND
Hungary;1556920;213285;1343635;2002;1;1;01/01/2002;HUN
Iceland;424615;58169;366446;2002;1;1;01/01/2002;ISL
India;4426284;606365;3819919;2002;1;1;01/01/2002;IND
Iran (Islamic Republic of);3036637;415995;2620642;2002;1;1;01/01/2002;IRN
Iraq;1312445;179794;1132651;2002;1;1;01/01/2002;IRQ
Ireland;3821530;523519;3298011;2002;1;1;01/01/2002;IRL
Israel;5378450;736804;4641646;2002;1;1;01/01/2002;ISR
Italy;65673707;8996765;56676942;2002;1;1;01/01/2002;ITA
Jamaica;51468;7051;44417;2002;1;1;01/01/2002;JAM
Japan;253083098;34670330;218412768;2002;1;1;01/01/2002;JPN
Jordan;102937;14101;88836;2002;1;1;01/01/2002;JOR
Kazakhstan;373146;51118;322028;2002;1;1;01/01/2002;KAZ
Kenya;102937;14101;88836;2002;1;1;01/01/2002;KEN
Kiribati;12867;1763;11104;2002;1;1;01/01/2002;KIR
Kuwait;1904332;260878;1643454;2002;1;1;01/01/2002;KWT
Kyrgyzstan;12867;1763;11104;2002;1;1;01/01/2002;KGZ
Lao People’s Democratic Republic;12867;1763;11104;2002;1;1;01/01/2002;LAO
Latvia;128671;17627;111044;2002;1;1;01/01/2002;LVA
Lebanon;154405;21152;133253;2002;1;1;01/01/2002;LBN
Lesotho;12867;1763;11104;2002;1;1;01/01/2002;LSO
Liberia;12867;1763;11104;2002;1;1;01/01/2002;LBR
Libya;862096;118100;743996;2002;1;1;01/01/2002;LBY
Liechtenstein;77203;10576;66627;2002;1;1;01/01/2002;LIE
Lithuania;218741;29966;188775;2002;1;1;01/01/2002;LTU
Luxembourg;1029368;141015;888353;2002;1;1;01/01/2002;LUX
Madagascar;38601;5288;33313;2002;1;1;01/01/2002;MDG
Malawi;25734;3525;22209;2002;1;1;01/01/2002;MWI
Malaysia;3049504;417757;2631747;2002;1;1;01/01/2002;MYS
Maldives;12867;1763;11104;2002;1;1;01/01/2002;MDV
Mali;25734;3525;22209;2002;1;1;01/01/2002;MLI
Malta;193007;26440;166567;2002;1;1;01/01/2002;MLT
Marshall Islands;12867;1763;11104;2002;1;1;01/01/2002;MHL
Mauritania;12867;1763;11104;2002;1;1;01/01/2002;MRT
Mauritius;141538;19389;122149;2002;1;1;01/01/2002;MUS
Mexico;14089481;1930144;12159337;2002;1;1;01/01/2002;MEX
Micronesia (Federated States of);12867;1763;11104;2002;1;1;01/01/2002;FSM
Monaco;51468;7051;44417;2002;1;1;01/01/2002;MCO
Mongolia;12867;1763;11104;2002;1;1;01/01/2002;MNG
Morocco;579020;79321;499699;2002;1;1;01/01/2002;MAR
Mozambique;12867;1763;11104;2002;1;1;01/01/2002;MOZ
Myanmar;128671;17627;111044;2002;1;1;01/01/2002;MMR
Namibia;90070;12339;77731;2002;1;1;01/01/2002;NAM
Nauru;12867;1763;11104;2002;1;1;01/01/2002;NRU
Nepal;51468;7051;44417;2002;1;1;01/01/2002;NPL
Netherlands;22530302;3086468;19443834;2002;1;1;01/01/2002;NLD
New Zealand;3126707;428333;2698374;2002;1;1;01/01/2002;NZL
Nicaragua;12867;1763;11104;2002;1;1;01/01/2002;NIC
Niger;12867;1763;11104;2002;1;1;01/01/2002;NER
Nigeria;720558;98710;621848;2002;1;1;01/01/2002;NGA
Norway;8389353;1149273;7240080;2002;1;1;01/01/2002;NOR
Oman;797761;109287;688474;2002;1;1;01/01/2002;OMN
Pakistan;784893;107524;677369;2002;1;1;01/01/2002;PAK
Palau;12867;1763;11104;2002;1;1;01/01/2002;PLW
Panama;231608;31728;199880;2002;1;1;01/01/2002;PAN
Papua New Guinea;77203;10576;66627;2002;1;1;01/01/2002;PNG
Paraguay;205874;28203;177671;2002;1;1;01/01/2002;PRY
Peru;1531186;209760;1321426;2002;1;1;01/01/2002;PER
Philippines;1299578;178032;1121546;2002;1;1;01/01/2002;PHL
Poland;4104607;562298;3542309;2002;1;1;01/01/2002;POL
Portugal;5996071;821413;5174658;2002;1;1;01/01/2002;PRT
Qatar;437482;59931;377551;2002;1;1;01/01/2002;QAT
Republic of Korea;24010019;3289178;20720841;2002;1;1;01/01/2002;KOR
Moldova;25734;3525;22209;2002;1;1;01/01/2002;MDA
Romania;759159;103999;655160;2002;1;1;01/01/2002;ROM
Russian Federation;15440527;2115227;13325300;2002;1;1;01/01/2002;RUS
Rwanda;12867;1763;11104;2002;1;1;01/01/2002;RWA
Saint Kitts and Nevis;12867;1763;11104;2002;1;1;01/01/2002;KN1
Saint Lucia;25734;3525;22209;2002;1;1;01/01/2002;LCA
Saint Vincent and the Grenadines;12867;1763;11104;2002;1;1;01/01/2002;VCT
Samoa;12867;1763;11104;2002;1;1;01/01/2002;WSM
San Marino;25734;3525;22209;2002;1;1;01/01/2002;SMR
Sao Tome and Principe;12867;1763;11104;2002;1;1;01/01/2002;STP
Saudi Arabia;7192712;985343;6207369;2002;1;1;01/01/2002;SAU
Senegal;64336;8813;55523;2002;1;1;01/01/2002;SEN
Seychelles;25734;3525;22209;2002;1;1;01/01/2002;SYC
Sierra Leone;12867;1763;11104;2002;1;1;01/01/2002;SLE
Singapore;5095374;698025;4397349;2002;1;1;01/01/2002;SGP
Slovakia;553286;75796;477490;2002;1;1;01/01/2002;SVK
Slovenia;1042236;142778;899458;2002;1;1;01/01/2002;SVN
Solomon Islands;12867;1763;11104;2002;1;1;01/01/2002;SLB
Somalia;12867;1763;11104;2002;1;1;01/01/2002;SOM
South Africa;5288380;724465;4563915;2002;1;1;01/01/2002;ZAF
Spain;32669581;4475467;28194114;2002;1;1;01/01/2002;ESP
Sri Lanka;205874;28203;177671;2002;1;1;01/01/2002;LKA
Sudan;77203;10576;66627;2002;1;1;01/01/2002;SDN
Suriname;25734;3525;22209;2002;1;1;01/01/2002;SUR
Swaziland;25734;3525;22209;2002;1;1;01/01/2002;SWZ
Sweden;13317454;1824383;11493071;2002;1;1;01/01/2002;SWE
Syrian Arab Republic;1042236;142778;899458;2002;1;1;01/01/2002;SYR
Tajikistan;12867;1763;11104;2002;1;1;01/01/2002;TJK
Thailand;3268245;447723;2820522;2002;1;1;01/01/2002;THA
North Macedonia;77203;10576;66627;2002;1;1;01/01/2002;MKD
Togo;12867;1763;11104;2002;1;1;01/01/2002;TGO
Tonga;12867;1763;11104;2002;1;1;01/01/2002;TON
Trinidad and Tobago;205874;28203;177671;2002;1;1;01/01/2002;TTO
Tunisia;398880;54643;344237;2002;1;1;01/01/2002;TUN
Turkey;5712995;756660a;4956335;2002;1;1;01/01/2002;TUR
Turkmenistan;38601;5288;33313;2002;1;1;01/01/2002;TKM
Tuvalu;12867;1763;11104;2002;1;1;01/01/2002;TUV
Uganda;64336;8813;55523;2002;1;1;01/01/2002;UGA
Ukraine;681957;93422;588535;2002;1;1;01/01/2002;UKR
United Arab Emirates;2624890;359588;2265302;2002;1;1;01/01/2002;ARE
United Kingdom of Great Britain and  Northern Ireland;71785582;9834042;61951540;2002;1;1;01/01/2002;GBR
United Republic of Tanzania;51468;7051;44417;2002;1;1;01/01/2002;TZA
United States of America;283076321;0a;283076321;2002;1;1;01/01/2002;USA
Uruguay;1042236;142778;899458;2002;1;1;01/01/2002;URY
Uzbekistan;141538;19389;122149;2002;1;1;01/01/2002;UZB
Vanuatu;12867;1763;11104;2002;1;1;01/01/2002;VUT
Venezuela;2702092;370165;2331927;2002;1;1;01/01/2002;VEN
Viet Nam;167272;22915;144357;2002;1;1;01/01/2002;VNM
Yemen;90070;12339;77731;2002;1;1;01/01/2002;YEM
Yugoslavia;257342;35254;222088;2002;1;1;01/01/2002;YUG
Zambia;25734;3525;22209;2002;1;1;01/01/2002;ZMB
Zimbabwe;102937;14101;88836;2002;1;1;01/01/2002;ZWE
Indonesia;2438897;359986;2078911;2001;1;1;01/01/2001;IDN
Afghanistan;97070;14328;82742;2001;1;1;01/01/2001;AFG
Albania;36401;5373;31028;2001;1;1;01/01/2001;ALB
Algeria;849367;125368;723999;2001;1;1;01/01/2001;DZA
Andorra;48535;7164;41371;2001;1;1;01/01/2001;AND
Angola;24268;3582;20686;2001;1;1;01/01/2001;AGO
Antigua and Barbuda;24268;3582;20686;2001;1;1;01/01/2001;ATG
Argentina;14026690;2070368;11956322;2001;1;1;01/01/2001;ARG
Armenia;24268;3582;20686;2001;1;1;01/01/2001;ARM
Australia;19850921;2930036;16920885;2001;1;1;01/01/2001;AUS
Austria;11551392;1705009;9846383;2001;1;1;01/01/2001;AUT
Azerbaijan;48535;7164;41371;2001;1;1;01/01/2001;AZE
Bahamas;145606;21492;124114;2001;1;1;01/01/2001;BHS
Bahrain;218409;32237;186172;2001;1;1;01/01/2001;BHR
Bangladesh;121338;17910;103428;2001;1;1;01/01/2001;BGD
Barbados;109204;16119;93085;2001;1;1;01/01/2001;BRB
Belarus;230542;34028;196514;2001;1;1;01/01/2001;BLR
Belgium;13784014;2034548;11749466;2001;1;1;01/01/2001;BEL
Belize;12134;1791;10343;2001;1;1;01/01/2001;BLZ
Benin;24268;3582;20686;2001;1;1;01/01/2001;BEN
Bhutan;12134;1791;10343;2001;1;1;01/01/2001;BTN
Bolivia;97070;14328;82742;2001;1;1;01/01/2001;BOL
Bosnia and Herzegovina;48535;7164;41371;2001;1;1;01/01/2001;BIH
Botswana;121338;17910;103428;2001;1;1;01/01/2001;BWA
Brazil;27070541;3995667;23074874;2001;1;1;01/01/2001;BRA
Brunei Darussalam;400416;59102;341314;2001;1;1;01/01/2001;BRN
Bulgaria;157739;23283;134456;2001;1;1;01/01/2001;BGR
Burkina Faso;24268;3582;20686;2001;1;1;01/01/2001;BFA
Burundi;12134;1791;10343;2001;1;1;01/01/2001;BDI
Cambodia;24268;3582;20686;2001;1;1;01/01/2001;KHM
Cameroon;109204;16119;93085;2001;1;1;01/01/2001;CMR
Canada;31220306;4608180;26612126;2001;1;1;01/01/2001;CAN
Cape Verde;12134;1791;10343;2001;1;1;01/01/2001;CPV
Central African Republic;12134;1791;10343;2001;1;1;01/01/2001;CAF
Chad;12134;1791;10343;2001;1;1;01/01/2001;TCD
Chile;2402495;354613;2047882;2001;1;1;01/01/2001;CHL
China;18698209;2759893;15938316;2001;1;1;01/01/2001;CHN
Colombia;2256889;333121;1923768;2001;1;1;01/01/2001;COL
Comoros;12134;1791;10343;2001;1;1;01/01/2001;COM
Congo;12134;1791;10343;2001;1;1;01/01/2001;COG
Costa Rica;242676;35819;206857;2001;1;1;01/01/2001;CRI
Côte d’Ivoire;109204;16119;93085;2001;1;1;01/01/2001;CIV
Croatia;473219;69848;403371;2001;1;1;01/01/2001;HRV
Cuba;364014;53729;310285;2001;1;1;01/01/2001;CUB
Cyprus;461085;68057;393028;2001;1;1;01/01/2001;CYP
Czech Republic;2293291;338494;1954797;2001;1;1;01/01/2001;CZE
Democratic People’s Republic of Korea;109204;16119;93085;2001;1;1;01/01/2001;PRK
Democratic Republic of the Congo;48535;7164;41371;2001;1;1;01/01/2001;ZAR
Denmark;9136762;1348605;7788157;2001;1;1;01/01/2001;DNK
Djibouti;12134;1791;10343;2001;1;1;01/01/2001;DJI
Dominica;12134;1791;10343;2001;1;1;01/01/2001;DMA
Dominican Republic;279078;41192;237886;2001;1;1;01/01/2001;DOM
Ecuador;303345;44774;258571;2001;1;1;01/01/2001;ECU
Egypt;982839;145069;837770;2001;1;1;01/01/2001;EGY
El Salvador;218409;32237;186172;2001;1;1;01/01/2001;SLV
Equatorial Guinea;12134;1791;10343;2001;1;1;01/01/2001;GNQ
Eritrea;12134;1791;10343;2001;1;1;01/01/2001;ERI
Estonia;121338;17910;103428;2001;1;1;01/01/2001;EST
Ethiopia;48535;7164;41371;2001;1;1;01/01/2001;ETH
Fiji;48535;7164;41371;2001;1;1;01/01/2001;FJI
Finland;6370253;940262;5429991;2001;1;1;01/01/2001;FIN
France;78906198;11646715;67259483;2001;1;1;01/01/2001;FRA
Gabon;169873;25074;144799;2001;1;1;01/01/2001;GAB
Gambia;12134;1791;10343;2001;1;1;01/01/2001;GMB
Georgia;60669;8955;51714;2001;1;1;01/01/2001;GEO
Germany;119214731;17596336;101618395;2001;1;1;01/01/2001;DEU
Ghana;60669;8955;51714;2001;1;1;01/01/2001;GHA
Greece;6576528;970709;5605819;2001;1;1;01/01/2001;GRC
Grenada;12134;1791;10343;2001;1;1;01/01/2001;GRD
Guatemala;327613;48356;279257;2001;1;1;01/01/2001;GTM
Guinea;36401;5373;31028;2001;1;1;01/01/2001;GIN
Guinea-Bissau;12134;1791;10343;2001;1;1;01/01/2001;GNB
Guyana;12134;1791;10343;2001;1;1;01/01/2001;GUY
Haiti;24268;3582;20686;2001;1;1;01/01/2001;HTI
Honduras;60669;8955;51714;2001;1;1;01/01/2001;HND
Hungary;1468191;216708;1251483;2001;1;1;01/01/2001;HUN
Iceland;400416;59102;341314;2001;1;1;01/01/2001;ISL
India;4161898;614305;3547593;2001;1;1;01/01/2001;IND
Iran (Islamic Republic of);3069855;453117;2616738;2001;1;1;01/01/2001;IRN
Iraq;1540994;227454;1313540;2001;1;1;01/01/2001;IRQ
Ireland;3591609;530129;3061480;2001;1;1;01/01/2001;IRL
Israel;5059801;746837;4312964;2001;1;1;01/01/2001;ISR
Italy;61809653;9123230;52686423;2001;1;1;01/01/2001;ITA
Jamaica;48535;7164;41371;2001;1;1;01/01/2001;JAM
Japan;238174652;35155061;203019591;2001;1;1;01/01/2001;JPN
Jordan;97070;14328;82742;2001;1;1;01/01/2001;JOR
Kazakhstan;351880;51938;299942;2001;1;1;01/01/2001;KAZ
Kenya;97070;14328;82742;2001;1;1;01/01/2001;KEN
Kiribati;12134;1791;10343;2001;1;1;01/01/2001;KIR
Kuwait;1795804;265064;1530740;2001;1;1;01/01/2001;KWT
Kyrgyzstan;12134;1791;10343;2001;1;1;01/01/2001;KGZ
Lao People’s Democratic Republic;12134;1791;10343;2001;1;1;01/01/2001;LAO
Latvia;121338;17910;103428;2001;1;1;01/01/2001;LVA
Lebanon;145606;21492;124114;2001;1;1;01/01/2001;LBN
Lesotho;12134;1791;10343;2001;1;1;01/01/2001;LSO
Liberia;12134;1791;10343;2001;1;1;01/01/2001;LBR
Libya;812965;119995;692970;2001;1;1;01/01/2001;LBY
Liechtenstein;72803;10746;62057;2001;1;1;01/01/2001;LIE
Lithuania;206275;30447;175828;2001;1;1;01/01/2001;LTU
Luxembourg;970705;143278;827427;2001;1;1;01/01/2001;LUX
Madagascar;36401;5373;31028;2001;1;1;01/01/2001;MDG
Malawi;24268;3582;20686;2001;1;1;01/01/2001;MWI
Malaysia;2875714;424461;2451253;2001;1;1;01/01/2001;MYS
Maldives;12134;1791;10343;2001;1;1;01/01/2001;MDV
Mali;24268;3582;20686;2001;1;1;01/01/2001;MLI
Malta;182007;26865;155142;2001;1;1;01/01/2001;MLT
Marshall Islands;12134;1791;10343;2001;1;1;01/01/2001;MHL
Mauritania;12134;1791;10343;2001;1;1;01/01/2001;MRT
Mauritius;133472;19701;113771;2001;1;1;01/01/2001;MUS
Mexico;13262260;1957536;11304724;2001;1;1;01/01/2001;MEX
Micronesia (Federated States of);12134;1791;10343;2001;1;1;01/01/2001;FSM
Monaco;48535;7164;41371;2001;1;1;01/01/2001;MCO
Mongolia;12134;1791;10343;2001;1;1;01/01/2001;MNG
Morocco;546022;80594;465428;2001;1;1;01/01/2001;MAR
Mozambique;12134;1791;10343;2001;1;1;01/01/2001;MOZ
Myanmar;121338;17910;103428;2001;1;1;01/01/2001;MMR
Namibia;84937;12537;72400;2001;1;1;01/01/2001;NAM
Nauru;12134;1791;10343;2001;1;1;01/01/2001;NRU
Nepal;48535;7164;41371;2001;1;1;01/01/2001;NPL
Netherlands;21209908;3130625;18079283;2001;1;1;01/01/2001;NLD
New Zealand;2936383;433416;2502967;2001;1;1;01/01/2001;NZL
Nicaragua;12134;1791;10343;2001;1;1;01/01/2001;NIC
Niger;12134;1791;10343;2001;1;1;01/01/2001;NER
Nigeria;752296;111040;641256;2001;1;1;01/01/2001;NGA
Norway;7886980;1164134;6722846;2001;1;1;01/01/2001;NOR
Oman;752296;111040;641256;2001;1;1;01/01/2001;OMN
Pakistan;740163;109249;630914;2001;1;1;01/01/2001;PAK
Palau;12134;1791;10343;2001;1;1;01/01/2001;PLW
Panama;218409;32237;186172;2001;1;1;01/01/2001;PAN
Papua New Guinea;72803;10746;62057;2001;1;1;01/01/2001;PNG
Paraguay;194141;28656;165485;2001;1;1;01/01/2001;PRY
Peru;1443924;213126;1230798;2001;1;1;01/01/2001;PER
Philippines;1225515;180889;1044626;2001;1;1;01/01/2001;PHL
Poland;4283237;632214;3651023;2001;1;1;01/01/2001;POL
Portugal;5642224;832804;4809420;2001;1;1;01/01/2001;PRT
Qatar;412550;60893;351657;2001;1;1;01/01/2001;QAT
Republic of Korea;20967232;3094806;17872426;2001;1;1;01/01/2001;KOR
Moldova;24268;3582;20686;2001;1;1;01/01/2001;MDA
Romania;715895;105668;610227;2001;1;1;01/01/2001;ROM
Russian Federation;14560578;2149171;12411407;2001;1;1;01/01/2001;RUS
Rwanda;12134;1791;10343;2001;1;1;01/01/2001;RWA
Saint Kitts and Nevis;12134;1791;10343;2001;1;1;01/01/2001;KN1
Saint Lucia;24268;3582;20686;2001;1;1;01/01/2001;LCA
Saint Vincent and the Grenadines;12134;1791;10343;2001;1;1;01/01/2001;VCT
Samoa;12134;1791;10343;2001;1;1;01/01/2001;WSM
San Marino;24268;3582;20686;2001;1;1;01/01/2001;SMR
Sao Tome and Principe;12134;1791;10343;2001;1;1;01/01/2001;STP
Saudi Arabia;6758535;997573;5760962;2001;1;1;01/01/2001;SAU
Senegal;60669;8955;51714;2001;1;1;01/01/2001;SEN
Seychelles;24268;3582;20686;2001;1;1;01/01/2001;SYC
Sierra Leone;12134;1791;10343;2001;1;1;01/01/2001;SLE
Singapore;4792857;707435;4085422;2001;1;1;01/01/2001;SGP
Slovakia;521754;77012;444742;2001;1;1;01/01/2001;SVK
Slovenia;982839;145069;837770;2001;1;1;01/01/2001;SVN
Solomon Islands;12134;1791;10343;2001;1;1;01/01/2001;SLB
Somalia;12134;1791;10343;2001;1;1;01/01/2001;SOM
South Africa;4974864;734300;4240564;2001;1;1;01/01/2001;ZAF
Spain;30747087;4538332;26208755;2001;1;1;01/01/2001;ESP
Sri Lanka;194141;28656;165485;2001;1;1;01/01/2001;LKA
Sudan;72803;10746;62057;2001;1;1;01/01/2001;SDN
Suriname;24268;3582;20686;2001;1;1;01/01/2001;SUR
Swaziland;24268;3582;20686;2001;1;1;01/01/2001;SWZ
Sweden;12534231;1850078;10684153;2001;1;1;01/01/2001;SWE
Syrian Arab Republic;982839;145069;837770;2001;1;1;01/01/2001;SYR
Tajikistan;12134;1791;10343;2001;1;1;01/01/2001;TJK
Thailand;3336799;492518;2844281;2001;1;1;01/01/2001;THA
North Macedonia;72803;10746;62057;2001;1;1;01/01/2001;MKD
Togo;12134;1791;10343;2001;1;1;01/01/2001;TGO
Tonga;12134;1791;10343;2001;1;1;01/01/2001;TON
Trinidad and Tobago;194141;28656;165485;2001;1;1;01/01/2001;TTO
Tunisia;376148;55520;320628;2001;1;1;01/01/2001;TUN
Turkey;5375280;769849a;4605431;2001;1;1;01/01/2001;TUR
Turkmenistan;36401;5373;31028;2001;1;1;01/01/2001;TKM
Tuvalu;12134;1791;10343;2001;1;1;01/01/2001;TUV
Uganda;60669;8955;51714;2001;1;1;01/01/2001;UGA
Ukraine;643092;94922;548170;2001;1;1;01/01/2001;UKR
United Arab Emirates;2475298;365359;2109939;2001;1;1;01/01/2001;ARE
United Kingdom of Great Britain and  Northern Ireland;67561081;9972152;57588929;2001;1;1;01/01/2001;GBR
United Republic of Tanzania;48535;7164;41371;2001;1;1;01/01/2001;TZA
United States of America;266943927;0a;266943927;2001;1;1;01/01/2001;USA
Uruguay;910036;134323;775713;2001;1;1;01/01/2001;URY
Uzbekistan;133472;19701;113771;2001;1;1;01/01/2001;UZB
Vanuatu;12134;1791;10343;2001;1;1;01/01/2001;VUT
Venezuela;2548101;376105;2171996;2001;1;1;01/01/2001;VEN
Viet Nam;182007;26865;155142;2001;1;1;01/01/2001;VNM
Yemen;84937;12537;72400;2001;1;1;01/01/2001;YEM
Yugoslavia;242676;35819;206857;2001;1;1;01/01/2001;YUG
Zambia;24268;3582;20686;2001;1;1;01/01/2001;ZMB
Zimbabwe;97070;14328;82742;2001;1;1;01/01/2001;ZWE
